"cluster","Aplke1.FilteredModels1","Aurli1.FilteredModels1","Honfer1.CEA_gene_models","LabyHa_1.DU_gene_models","Schag1.FilteredModels1","TOTAL"
1,48,96,71,8,99,322
2,57,62,54,65,67,305
3,42,67,65,32,58,264
4,62,84,47,18,44,255
5,83,78,51,10,27,249
6,24,63,59,20,61,227
7,55,46,39,32,47,219
8,27,30,58,15,86,216
9,39,52,43,25,51,210
10,51,36,31,41,43,202
11,41,45,44,32,38,200
12,38,23,66,7,49,183
13,63,9,64,34,8,178
14,0,0,2,161,0,163
15,30,33,29,30,34,156
16,27,32,28,28,32,147
17,30,31,29,22,33,145
18,2,0,0,138,0,140
19,31,25,22,22,25,125
20,26,27,25,18,24,120
21,1,1,1,112,1,116
22,1,44,65,0,5,115
23,37,29,12,15,17,110
24,22,16,10,45,13,106
25,13,32,16,14,31,106
26,26,20,19,16,21,102
27,1,0,0,101,0,102
28,17,29,14,9,31,100
29,23,10,9,40,18,100
30,0,0,0,98,0,98
31,34,12,13,24,14,97
32,0,0,0,92,0,92
33,17,22,17,1,23,80
34,1,4,68,0,5,78
35,16,20,10,9,22,77
36,26,14,13,10,14,77
37,2,25,13,11,25,76
38,25,11,7,23,8,74
39,28,1,0,43,0,72
40,14,8,1,26,23,72
41,17,14,11,10,19,71
42,1,21,19,11,19,71
43,14,12,15,18,11,70
44,0,0,0,67,0,67
45,13,13,7,10,23,66
46,4,26,25,2,7,64
47,13,13,11,5,20,62
48,15,16,10,5,16,62
49,18,5,9,23,6,61
50,15,12,12,9,13,61
51,7,16,14,6,18,61
52,15,12,10,12,11,60
53,0,12,10,0,37,59
54,9,22,20,1,6,58
55,6,17,14,8,12,57
56,8,9,7,10,21,55
57,11,12,11,10,11,55
58,12,5,0,25,12,54
59,10,12,13,8,11,54
60,0,1,0,53,0,54
61,0,0,0,54,0,54
62,9,10,10,7,13,49
63,0,1,3,45,0,49
64,17,11,6,6,8,48
65,13,24,2,5,3,47
66,0,0,0,47,0,47
67,2,12,13,9,10,46
68,46,0,0,0,0,46
69,10,11,5,4,14,44
70,11,10,11,1,9,42
71,16,10,9,1,6,42
72,13,10,10,2,7,42
73,14,9,7,5,7,42
74,13,10,6,3,10,42
75,1,11,8,0,22,42
76,12,12,2,3,12,41
77,7,9,9,9,7,41
78,1,13,11,1,15,41
79,0,0,0,41,0,41
80,16,7,8,0,9,40
81,11,1,1,16,11,40
82,9,7,7,10,7,40
83,6,11,8,5,10,40
84,20,2,0,11,7,40
85,14,5,7,5,9,40
86,8,8,8,8,8,40
87,7,10,8,4,11,40
88,6,9,7,7,10,39
89,0,13,26,0,0,39
90,0,0,0,39,0,39
91,0,0,0,39,0,39
92,8,8,8,6,8,38
93,0,0,0,38,0,38
94,7,7,8,8,7,37
95,0,12,19,2,4,37
96,6,9,7,2,12,36
97,0,0,0,36,0,36
98,35,0,0,0,0,35
99,7,7,7,7,7,35
100,0,35,0,0,0,35
101,12,6,4,5,7,34
102,14,7,5,0,8,34
103,9,3,3,11,8,34
104,2,0,0,32,0,34
105,0,34,0,0,0,34
106,7,11,6,1,8,33
107,9,7,5,7,5,33
108,5,7,3,8,10,33
109,1,2,29,0,1,33
110,9,8,4,3,8,32
111,8,6,8,5,5,32
112,6,7,6,6,7,32
113,5,8,7,2,10,32
114,4,9,8,3,8,32
115,0,1,3,28,0,32
116,6,6,8,6,5,31
117,2,1,0,26,2,31
118,7,5,6,7,6,31
119,6,5,2,5,13,31
120,7,7,7,2,8,31
121,5,10,9,0,7,31
122,12,6,6,1,5,30
123,3,9,5,3,10,30
124,9,3,3,9,6,30
125,6,8,10,2,4,30
126,3,1,0,26,0,30
127,0,21,9,0,0,30
128,7,7,5,4,6,29
129,6,5,5,7,6,29
130,6,7,6,7,3,29
131,6,12,8,1,1,28
132,14,4,3,2,5,28
133,3,7,6,4,8,28
134,10,5,5,4,4,28
135,8,5,5,4,6,28
136,0,20,7,0,1,28
137,7,7,5,2,6,27
138,7,4,11,2,3,27
139,9,7,6,1,4,27
140,6,5,4,7,5,27
141,5,6,3,7,6,27
142,7,8,5,1,6,27
143,0,27,0,0,0,27
144,3,8,6,2,7,26
145,2,10,12,1,1,26
146,5,4,3,8,5,25
147,25,0,0,0,0,25
148,5,6,4,3,7,25
149,10,5,4,3,3,25
150,7,1,2,14,1,25
151,6,4,4,5,6,25
152,8,5,3,2,7,25
153,6,5,5,4,5,25
154,4,7,3,2,9,25
155,4,6,5,7,3,25
156,0,7,6,5,7,25
157,8,4,4,5,3,24
158,6,4,4,4,6,24
159,2,0,16,6,0,24
160,5,9,7,1,2,24
161,8,3,2,4,7,24
162,10,2,2,3,7,24
163,5,6,6,1,6,24
164,6,7,5,3,3,24
165,3,7,4,0,9,23
166,5,4,4,5,5,23
167,4,4,5,3,7,23
168,20,0,0,3,0,23
169,4,3,3,7,6,23
170,4,1,1,14,3,23
171,0,10,13,0,0,23
172,0,0,0,23,0,23
173,2,8,4,3,5,22
174,8,1,12,0,1,22
175,14,0,0,8,0,22
176,5,5,4,4,4,22
177,7,4,3,2,6,22
178,4,6,6,3,3,22
179,6,3,3,4,6,22
180,9,2,3,6,2,22
181,3,4,7,3,5,22
182,8,3,4,3,3,21
183,5,0,0,16,0,21
184,6,5,4,3,3,21
185,19,0,0,2,0,21
186,6,5,4,2,4,21
187,5,2,2,8,4,21
188,3,5,4,4,5,21
189,4,6,6,0,5,21
190,5,4,4,3,5,21
191,6,4,3,4,4,21
192,3,2,3,13,0,21
193,2,7,6,0,6,21
194,1,3,4,10,3,21
195,5,4,4,4,4,21
196,0,13,7,0,1,21
197,0,0,0,21,0,21
198,0,0,0,20,1,21
199,0,0,0,21,0,21
200,0,0,0,21,0,21
201,8,2,2,6,2,20
202,3,5,4,2,6,20
203,5,3,2,6,4,20
204,4,6,5,0,5,20
205,6,1,4,5,4,20
206,6,2,2,8,2,20
207,6,4,4,2,4,20
208,11,2,2,4,1,20
209,7,4,4,1,4,20
210,2,4,4,3,7,20
211,4,4,3,3,6,20
212,4,5,4,4,3,20
213,5,5,5,0,5,20
214,5,4,5,2,4,20
215,4,8,3,0,5,20
216,5,4,4,3,4,20
217,4,4,2,6,4,20
218,3,5,9,1,2,20
219,0,7,6,2,5,20
220,0,0,0,0,20,20
221,0,0,0,20,0,20
222,0,0,0,20,0,20
223,4,5,4,1,5,19
224,4,1,2,7,5,19
225,19,0,0,0,0,19
226,8,3,6,0,2,19
227,7,2,2,6,2,19
228,2,7,3,2,5,19
229,4,4,3,3,5,19
230,17,0,0,2,0,19
231,5,6,3,1,4,19
232,1,0,2,15,1,19
233,5,4,7,2,1,19
234,5,4,3,3,4,19
235,6,3,4,3,3,19
236,4,2,9,0,4,19
237,3,3,6,4,3,19
238,4,5,4,2,4,19
239,7,2,3,4,3,19
240,7,5,3,0,4,19
241,3,4,4,4,4,19
242,4,4,4,3,4,19
243,4,7,5,0,3,19
244,9,3,2,3,2,19
245,0,5,10,0,4,19
246,0,5,5,4,5,19
247,7,3,2,1,5,18
248,4,3,3,4,4,18
249,6,3,3,2,4,18
250,4,4,3,2,5,18
251,4,4,3,2,5,18
252,9,1,1,7,0,18
253,3,5,4,2,4,18
254,9,5,3,0,1,18
255,4,4,4,2,4,18
256,8,4,3,1,2,18
257,4,9,1,0,4,18
258,5,4,3,1,5,18
259,3,4,4,3,4,18
260,4,5,4,1,4,18
261,4,3,3,3,5,18
262,4,6,5,0,3,18
263,3,4,4,3,4,18
264,3,4,4,2,5,18
265,6,3,3,1,5,18
266,5,0,0,10,3,18
267,8,3,3,0,4,18
268,5,4,2,4,3,18
269,3,4,4,2,5,18
270,5,5,3,3,2,18
271,5,3,2,5,3,18
272,0,11,3,3,1,18
273,0,8,3,2,5,18
274,0,9,6,0,3,18
275,1,2,12,0,3,18
276,0,15,2,0,1,18
277,5,4,4,0,4,17
278,3,3,3,3,5,17
279,3,4,3,3,4,17
280,4,3,3,4,3,17
281,5,3,3,2,4,17
282,6,3,3,2,3,17
283,2,5,1,1,8,17
284,6,5,5,0,1,17
285,3,3,2,2,7,17
286,5,4,4,3,1,17
287,7,3,3,1,3,17
288,2,5,4,3,3,17
289,3,7,0,1,6,17
290,3,3,3,5,3,17
291,4,4,4,2,3,17
292,3,4,2,4,4,17
293,0,7,6,0,4,17
294,0,11,5,0,1,17
295,0,0,0,17,0,17
296,0,6,7,0,4,17
297,0,4,2,10,1,17
298,0,11,4,0,2,17
299,0,0,0,17,0,17
300,0,0,0,16,1,17
301,0,0,0,17,0,17
302,5,2,1,7,1,16
303,3,3,3,5,2,16
304,8,3,3,2,0,16
305,4,2,3,5,2,16
306,3,3,3,4,3,16
307,3,3,4,3,3,16
308,4,3,4,2,3,16
309,3,4,3,2,4,16
310,2,5,3,2,4,16
311,3,3,4,2,4,16
312,6,2,2,1,5,16
313,4,3,3,3,3,16
314,1,4,3,2,6,16
315,3,4,3,3,3,16
316,5,2,1,6,2,16
317,2,4,4,2,4,16
318,3,0,1,11,1,16
319,5,2,2,5,2,16
320,3,2,2,6,3,16
321,3,5,3,1,4,16
322,3,4,3,3,3,16
323,0,6,5,0,5,16
324,0,0,0,16,0,16
325,0,6,3,3,4,16
326,4,3,3,1,4,15
327,10,1,2,1,1,15
328,4,4,4,2,1,15
329,6,4,1,2,2,15
330,2,4,2,4,3,15
331,5,3,2,3,2,15
332,2,5,4,0,4,15
333,3,5,0,0,7,15
334,2,4,4,2,3,15
335,7,3,5,0,0,15
336,5,3,2,2,3,15
337,5,3,3,1,3,15
338,4,6,0,2,3,15
339,12,0,1,0,2,15
340,5,3,3,1,3,15
341,4,4,3,1,3,15
342,2,6,4,2,1,15
343,15,0,0,0,0,15
344,4,4,3,2,2,15
345,3,4,4,1,3,15
346,5,3,3,2,2,15
347,2,4,3,3,3,15
348,2,3,3,2,5,15
349,3,4,4,1,3,15
350,2,5,3,1,4,15
351,2,3,3,4,3,15
352,2,4,3,2,4,15
353,3,3,3,3,3,15
354,0,6,5,1,3,15
355,0,15,0,0,0,15
356,0,6,4,0,5,15
357,1,5,3,0,6,15
358,1,6,6,0,2,15
359,1,3,10,0,1,15
360,2,3,4,2,3,14
361,5,3,3,0,3,14
362,8,2,2,1,1,14
363,3,6,4,0,1,14
364,3,3,3,2,3,14
365,3,3,3,2,3,14
366,2,4,4,2,2,14
367,3,5,3,0,3,14
368,4,5,3,1,1,14
369,7,2,2,1,2,14
370,5,2,2,2,3,14
371,4,3,3,2,2,14
372,5,2,2,3,2,14
373,9,0,0,5,0,14
374,2,5,3,0,4,14
375,3,3,4,1,3,14
376,3,2,2,5,2,14
377,2,4,4,0,4,14
378,2,5,2,0,5,14
379,3,3,3,1,4,14
380,2,3,3,2,4,14
381,5,2,2,2,3,14
382,5,4,1,0,4,14
383,3,4,3,1,3,14
384,3,2,2,3,4,14
385,2,3,3,2,4,14
386,4,2,3,1,4,14
387,7,2,1,2,2,14
388,3,3,3,2,3,14
389,3,3,3,2,3,14
390,3,4,2,1,4,14
391,4,2,2,3,3,14
392,3,3,3,2,3,14
393,4,3,3,2,2,14
394,4,2,3,3,2,14
395,3,4,3,2,2,14
396,2,4,4,1,3,14
397,1,8,3,0,2,14
398,0,10,4,0,0,14
399,1,4,6,3,0,14
400,1,6,7,0,0,14
401,0,6,2,1,5,14
402,0,0,0,14,0,14
403,0,5,5,0,4,14
404,0,5,7,2,0,14
405,0,1,0,0,13,14
406,0,0,0,13,1,14
407,3,3,3,2,2,13
408,5,3,5,0,0,13
409,4,2,3,2,2,13
410,3,5,2,1,2,13
411,5,4,4,0,0,13
412,4,3,3,1,2,13
413,13,0,0,0,0,13
414,4,2,2,3,2,13
415,3,2,2,2,4,13
416,4,3,3,0,3,13
417,1,4,4,1,3,13
418,4,4,3,1,1,13
419,2,3,3,2,3,13
420,2,5,2,2,2,13
421,1,0,0,10,2,13
422,2,0,1,4,6,13
423,5,1,1,5,1,13
424,3,4,2,1,3,13
425,13,0,0,0,0,13
426,3,3,3,1,3,13
427,2,2,2,4,3,13
428,3,2,2,4,2,13
429,4,1,1,5,2,13
430,2,3,2,3,3,13
431,2,3,4,1,3,13
432,2,6,4,1,0,13
433,3,3,2,2,3,13
434,7,2,2,1,1,13
435,3,3,2,3,2,13
436,2,2,2,3,4,13
437,4,3,2,2,2,13
438,5,2,2,1,3,13
439,3,3,3,2,2,13
440,3,3,2,2,3,13
441,4,1,1,6,1,13
442,2,3,3,2,3,13
443,4,2,2,2,3,13
444,4,2,3,1,3,13
445,3,3,2,3,2,13
446,3,3,2,3,2,13
447,3,3,3,1,3,13
448,1,1,10,0,1,13
449,0,6,4,0,3,13
450,1,2,2,5,3,13
451,1,5,4,1,2,13
452,1,4,2,2,4,13
453,0,5,4,0,4,13
454,0,1,6,0,6,13
455,0,2,2,0,9,13
456,0,1,12,0,0,13
457,0,0,0,13,0,13
458,0,0,0,0,13,13
459,1,0,0,0,12,13
460,0,1,7,0,5,13
461,0,3,9,0,1,13
462,0,5,4,0,4,13
463,0,0,0,12,1,13
464,0,0,0,13,0,13
465,0,0,0,13,0,13
466,3,2,2,2,3,12
467,3,3,3,1,2,12
468,6,3,3,0,0,12
469,4,3,2,1,2,12
470,1,4,3,2,2,12
471,3,4,4,0,1,12
472,3,4,3,1,1,12
473,2,2,2,3,3,12
474,4,2,2,2,2,12
475,3,2,2,3,2,12
476,3,2,2,2,3,12
477,2,2,3,2,3,12
478,6,1,1,3,1,12
479,5,1,0,3,3,12
480,3,3,2,2,2,12
481,3,2,2,2,3,12
482,2,3,3,1,3,12
483,2,3,2,2,3,12
484,12,0,0,0,0,12
485,6,0,0,4,2,12
486,3,3,2,2,2,12
487,5,1,1,3,2,12
488,2,3,2,1,4,12
489,4,3,3,0,2,12
490,5,2,2,2,1,12
491,3,3,2,1,3,12
492,2,2,2,1,5,12
493,3,2,2,2,3,12
494,1,2,1,3,5,12
495,3,3,2,2,2,12
496,2,4,2,0,4,12
497,3,2,2,3,2,12
498,4,4,0,0,4,12
499,3,2,2,3,2,12
500,4,2,2,2,2,12
501,2,3,3,1,3,12
502,1,1,1,8,1,12
503,5,3,2,1,1,12
504,2,4,4,0,2,12
505,2,2,3,2,3,12
506,3,2,2,2,3,12
507,1,4,2,1,4,12
508,0,9,3,0,0,12
509,1,1,1,0,9,12
510,0,9,3,0,0,12
511,0,3,9,0,0,12
512,0,0,12,0,0,12
513,0,0,0,12,0,12
514,0,0,0,12,0,12
515,0,1,1,0,10,12
516,0,1,1,7,3,12
517,0,10,2,0,0,12
518,0,3,6,2,1,12
519,0,6,4,0,2,12
520,2,3,2,1,3,11
521,2,2,2,4,1,11
522,3,3,3,1,1,11
523,2,3,3,2,1,11
524,1,1,4,3,2,11
525,4,3,1,2,1,11
526,3,2,2,2,2,11
527,5,2,1,1,2,11
528,2,3,2,2,2,11
529,3,2,2,2,2,11
530,5,1,2,2,1,11
531,3,2,2,2,2,11
532,3,1,2,2,3,11
533,11,0,0,0,0,11
534,3,3,2,1,2,11
535,3,2,2,2,2,11
536,3,3,2,2,1,11
537,4,2,3,1,1,11
538,3,3,3,1,1,11
539,4,2,1,3,1,11
540,2,1,2,0,6,11
541,5,1,1,2,2,11
542,2,0,0,4,5,11
543,1,2,2,4,2,11
544,2,3,3,1,2,11
545,3,2,2,1,3,11
546,3,2,2,2,2,11
547,4,2,1,2,2,11
548,4,2,2,3,0,11
549,2,2,2,4,1,11
550,2,3,3,0,3,11
551,4,2,2,1,2,11
552,4,3,2,1,1,11
553,2,3,3,0,3,11
554,1,3,2,2,3,11
555,2,3,3,1,2,11
556,11,0,0,0,0,11
557,2,2,2,3,2,11
558,3,2,2,1,3,11
559,2,1,1,3,4,11
560,3,4,3,1,0,11
561,3,2,2,1,3,11
562,2,4,2,1,2,11
563,2,2,2,2,3,11
564,4,2,1,2,2,11
565,4,2,3,1,1,11
566,4,2,2,1,2,11
567,2,2,2,2,3,11
568,2,3,2,0,4,11
569,4,2,2,1,2,11
570,5,1,1,3,1,11
571,3,1,2,3,2,11
572,3,3,3,0,2,11
573,2,2,2,3,2,11
574,3,2,3,1,2,11
575,2,3,2,2,2,11
576,3,2,2,2,2,11
577,3,2,2,2,2,11
578,6,1,1,2,1,11
579,3,2,2,2,2,11
580,1,0,0,9,1,11
581,3,2,2,2,2,11
582,2,3,2,1,3,11
583,3,6,2,0,0,11
584,2,2,2,3,2,11
585,2,2,2,3,2,11
586,2,2,2,2,3,11
587,2,3,2,1,3,11
588,1,2,1,1,6,11
589,0,3,8,0,0,11
590,1,2,6,1,1,11
591,1,3,3,0,4,11
592,1,5,1,1,3,11
593,1,4,6,0,0,11
594,1,4,3,2,1,11
595,0,3,6,1,1,11
596,0,1,6,3,1,11
597,0,0,0,11,0,11
598,0,0,0,11,0,11
599,0,0,0,11,0,11
600,0,0,0,11,0,11
601,0,0,0,0,11,11
602,0,9,0,0,2,11
603,0,0,0,0,11,11
604,0,0,0,11,0,11
605,3,2,2,1,2,10
606,3,3,2,0,2,10
607,2,2,2,2,2,10
608,2,0,0,7,1,10
609,2,2,2,2,2,10
610,2,2,2,2,2,10
611,2,3,3,1,1,10
612,2,2,2,3,1,10
613,2,2,2,2,2,10
614,2,2,2,2,2,10
615,2,2,2,2,2,10
616,2,3,4,0,1,10
617,8,0,0,2,0,10
618,2,3,2,2,1,10
619,4,1,2,1,2,10
620,10,0,0,0,0,10
621,2,2,2,2,2,10
622,2,2,2,2,2,10
623,3,2,2,1,2,10
624,1,4,3,0,2,10
625,2,2,4,0,2,10
626,2,2,2,2,2,10
627,3,3,2,0,2,10
628,2,2,2,2,2,10
629,2,3,3,0,2,10
630,3,2,1,4,0,10
631,1,3,2,2,2,10
632,5,1,1,2,1,10
633,1,3,3,0,3,10
634,3,1,2,2,2,10
635,2,2,2,2,2,10
636,4,2,2,0,2,10
637,2,2,2,2,2,10
638,1,2,3,2,2,10
639,4,2,2,1,1,10
640,4,2,2,0,2,10
641,3,2,3,2,0,10
642,3,4,2,0,1,10
643,2,3,2,1,2,10
644,2,2,2,2,2,10
645,4,1,1,2,2,10
646,2,2,2,2,2,10
647,3,2,1,1,3,10
648,1,3,2,1,3,10
649,3,2,2,1,2,10
650,2,2,2,1,3,10
651,3,3,2,0,2,10
652,4,3,2,0,1,10
653,2,2,2,2,2,10
654,2,2,2,2,2,10
655,2,2,2,2,2,10
656,2,2,2,2,2,10
657,2,2,2,2,2,10
658,2,2,2,2,2,10
659,3,2,2,1,2,10
660,2,2,2,2,2,10
661,2,4,2,1,1,10
662,1,3,4,1,1,10
663,2,2,2,2,2,10
664,2,3,4,0,1,10
665,2,2,2,2,2,10
666,2,2,2,1,3,10
667,2,2,2,2,2,10
668,3,2,2,1,2,10
669,2,2,2,2,2,10
670,2,2,2,2,2,10
671,2,2,1,2,3,10
672,2,2,2,2,2,10
673,3,2,2,1,2,10
674,1,1,1,7,0,10
675,3,2,2,0,3,10
676,2,2,2,2,2,10
677,2,2,2,2,2,10
678,3,2,2,1,2,10
679,2,2,2,2,2,10
680,10,0,0,0,0,10
681,1,2,2,2,3,10
682,4,1,1,2,2,10
683,3,2,2,1,2,10
684,2,2,2,2,2,10
685,2,2,1,4,1,10
686,2,2,2,2,2,10
687,2,2,2,2,2,10
688,2,2,2,2,2,10
689,3,3,3,0,1,10
690,2,2,2,2,2,10
691,1,2,3,1,3,10
692,3,1,1,5,0,10
693,2,2,2,2,2,10
694,2,2,2,2,2,10
695,2,2,2,1,3,10
696,3,2,2,1,2,10
697,4,1,1,1,3,10
698,3,2,2,1,2,10
699,3,2,2,1,2,10
700,3,2,2,1,2,10
701,2,2,2,2,2,10
702,3,2,2,1,2,10
703,3,2,1,2,2,10
704,2,2,2,2,2,10
705,1,3,1,1,4,10
706,2,2,2,2,2,10
707,2,2,2,2,2,10
708,2,3,2,0,3,10
709,5,0,5,0,0,10
710,2,2,2,2,2,10
711,2,0,0,7,1,10
712,2,2,2,2,2,10
713,2,2,2,2,2,10
714,2,3,2,1,2,10
715,2,2,2,2,2,10
716,2,2,2,2,2,10
717,2,2,2,2,2,10
718,2,2,2,2,2,10
719,0,2,5,1,2,10
720,1,4,2,2,1,10
721,1,3,4,1,1,10
722,0,3,6,0,1,10
723,1,6,3,0,0,10
724,0,3,4,0,3,10
725,0,4,3,0,3,10
726,0,6,4,0,0,10
727,0,4,4,0,2,10
728,1,1,4,4,0,10
729,1,2,2,3,2,10
730,2,3,1,2,2,10
731,0,2,3,2,3,10
732,1,3,5,0,1,10
733,1,3,2,0,4,10
734,1,2,2,3,2,10
735,0,1,9,0,0,10
736,0,2,2,2,4,10
737,0,0,10,0,0,10
738,0,0,0,10,0,10
739,0,0,0,10,0,10
740,0,8,1,1,0,10
741,0,4,3,0,3,10
742,0,10,0,0,0,10
743,0,2,3,0,5,10
744,0,5,5,0,0,10
745,0,3,2,0,5,10
746,0,0,0,10,0,10
747,0,0,0,10,0,10
748,0,0,0,10,0,10
749,0,0,0,10,0,10
750,2,2,2,1,2,9
751,2,2,2,1,2,9
752,2,2,2,1,2,9
753,3,2,1,3,0,9
754,5,0,0,3,1,9
755,2,2,2,1,2,9
756,4,1,1,2,1,9
757,1,1,1,1,5,9
758,7,0,1,1,0,9
759,5,1,1,0,2,9
760,2,2,2,1,2,9
761,2,2,2,1,2,9
762,2,3,3,1,0,9
763,3,2,2,0,2,9
764,3,2,2,1,1,9
765,2,2,2,1,2,9
766,2,2,1,2,2,9
767,2,3,0,2,2,9
768,2,2,1,2,2,9
769,4,0,0,4,1,9
770,8,0,0,1,0,9
771,7,0,0,1,1,9
772,7,1,1,0,0,9
773,2,1,2,2,2,9
774,2,2,1,2,2,9
775,2,1,1,4,1,9
776,2,2,2,1,2,9
777,2,2,2,1,2,9
778,2,2,2,1,2,9
779,1,3,3,0,2,9
780,2,2,2,1,2,9
781,2,2,1,2,2,9
782,4,2,1,1,1,9
783,3,2,2,1,1,9
784,3,0,0,6,0,9
785,1,2,2,1,3,9
786,3,2,1,2,1,9
787,1,2,2,1,3,9
788,2,1,1,4,1,9
789,1,3,2,1,2,9
790,2,2,2,1,2,9
791,4,1,1,2,1,9
792,2,2,2,1,2,9
793,2,2,2,1,2,9
794,2,4,0,0,3,9
795,5,1,1,1,1,9
796,2,2,2,1,2,9
797,2,1,3,3,0,9
798,3,2,2,0,2,9
799,2,2,2,1,2,9
800,6,0,1,1,1,9
801,5,1,1,2,0,9
802,2,2,1,1,3,9
803,2,3,2,1,1,9
804,1,2,2,2,2,9
805,2,2,2,1,2,9
806,2,1,1,3,2,9
807,2,2,2,1,2,9
808,2,2,2,1,2,9
809,2,2,2,1,2,9
810,2,2,2,2,1,9
811,6,1,1,0,1,9
812,7,0,0,2,0,9
813,2,2,2,1,2,9
814,2,2,2,1,2,9
815,3,2,2,1,1,9
816,2,2,2,1,2,9
817,2,2,2,1,2,9
818,2,2,2,1,2,9
819,1,2,4,0,2,9
820,2,2,2,1,2,9
821,2,2,2,1,2,9
822,2,2,2,1,2,9
823,2,2,2,1,2,9
824,3,2,2,0,2,9
825,2,2,2,1,2,9
826,4,1,1,2,1,9
827,2,0,3,2,2,9
828,2,2,2,1,2,9
829,2,3,3,0,1,9
830,2,2,2,2,1,9
831,1,2,2,2,2,9
832,2,2,3,1,1,9
833,1,0,1,7,0,9
834,1,4,2,1,1,9
835,3,2,2,1,1,9
836,2,1,2,2,2,9
837,2,2,2,1,2,9
838,3,1,1,2,2,9
839,3,1,1,2,2,9
840,2,2,2,1,2,9
841,2,2,2,1,2,9
842,5,0,1,2,1,9
843,2,2,2,1,2,9
844,1,2,2,2,2,9
845,2,2,2,1,2,9
846,2,2,2,1,2,9
847,2,2,2,1,2,9
848,3,3,2,0,1,9
849,3,3,1,2,0,9
850,3,3,2,0,1,9
851,2,2,2,2,1,9
852,2,2,2,1,2,9
853,3,2,2,0,2,9
854,2,0,0,7,0,9
855,2,2,2,1,2,9
856,1,3,2,1,2,9
857,2,2,2,1,2,9
858,2,2,2,1,2,9
859,2,2,2,1,2,9
860,2,2,1,2,2,9
861,2,2,1,0,4,9
862,1,3,2,1,2,9
863,2,2,1,2,2,9
864,1,3,1,1,3,9
865,1,2,2,2,2,9
866,1,3,2,2,1,9
867,1,2,2,1,3,9
868,1,3,3,1,1,9
869,0,5,4,0,0,9
870,0,3,1,1,4,9
871,2,3,2,0,2,9
872,2,3,2,1,1,9
873,1,4,4,0,0,9
874,1,2,2,2,2,9
875,1,1,1,5,1,9
876,0,1,8,0,0,9
877,1,3,2,1,2,9
878,1,1,1,5,1,9
879,1,2,2,1,3,9
880,1,1,1,5,1,9
881,0,5,2,0,2,9
882,0,2,2,1,4,9
883,0,0,9,0,0,9
884,0,7,2,0,0,9
885,0,3,3,0,3,9
886,0,0,0,9,0,9
887,0,2,2,2,3,9
888,0,3,2,1,3,9
889,0,4,3,0,2,9
890,0,9,0,0,0,9
891,0,3,3,0,3,9
892,0,3,3,0,3,9
893,0,9,0,0,0,9
894,0,9,0,0,0,9
895,0,4,2,0,3,9
896,0,4,3,0,2,9
897,0,2,2,3,2,9
898,0,4,3,1,1,9
899,0,9,0,0,0,9
900,0,3,2,1,3,9
901,0,1,8,0,0,9
902,0,0,0,9,0,9
903,0,0,0,0,9,9
904,0,0,0,9,0,9
905,0,0,0,0,9,9
906,3,0,0,2,3,8
907,3,1,1,2,1,8
908,2,2,1,1,2,8
909,3,1,2,1,1,8
910,1,4,2,0,1,8
911,1,1,1,4,1,8
912,2,2,1,0,3,8
913,4,0,0,3,1,8
914,2,1,1,1,3,8
915,2,1,3,1,1,8
916,4,1,1,1,1,8
917,2,2,1,1,2,8
918,2,2,1,1,2,8
919,2,2,1,1,2,8
920,1,2,2,3,0,8
921,2,2,2,0,2,8
922,1,1,4,2,0,8
923,2,1,2,0,3,8
924,1,3,2,1,1,8
925,3,1,3,0,1,8
926,3,1,1,1,2,8
927,4,1,1,0,2,8
928,3,1,1,2,1,8
929,1,2,2,1,2,8
930,2,2,1,1,2,8
931,3,2,2,0,1,8
932,3,1,1,1,2,8
933,3,1,1,2,1,8
934,3,1,1,2,1,8
935,1,2,3,0,2,8
936,1,2,2,1,2,8
937,3,1,1,2,1,8
938,6,0,0,2,0,8
939,1,2,2,2,1,8
940,4,1,1,0,2,8
941,4,1,1,0,2,8
942,2,1,1,2,2,8
943,1,3,1,2,1,8
944,1,2,2,1,2,8
945,2,2,1,1,2,8
946,2,2,2,0,2,8
947,1,2,3,1,1,8
948,5,1,1,0,1,8
949,2,1,2,2,1,8
950,2,2,2,1,1,8
951,3,1,1,2,1,8
952,2,1,2,1,2,8
953,3,2,2,0,1,8
954,3,1,1,2,1,8
955,2,3,1,1,1,8
956,8,0,0,0,0,8
957,2,2,2,0,2,8
958,2,2,1,2,1,8
959,3,1,1,2,1,8
960,3,1,1,1,2,8
961,1,2,2,0,3,8
962,3,1,2,0,2,8
963,7,0,0,1,0,8
964,3,2,0,1,2,8
965,2,2,2,0,2,8
966,2,2,2,0,2,8
967,2,2,2,0,2,8
968,2,2,2,0,2,8
969,3,1,1,2,1,8
970,2,2,2,1,1,8
971,1,2,1,1,3,8
972,2,0,0,6,0,8
973,5,0,0,2,1,8
974,2,1,1,2,2,8
975,7,0,0,1,0,8
976,2,2,2,1,1,8
977,3,2,1,0,2,8
978,4,1,1,1,1,8
979,2,1,2,1,2,8
980,1,7,0,0,0,8
981,3,1,0,3,1,8
982,4,1,1,2,0,8
983,2,1,2,1,2,8
984,1,1,1,3,2,8
985,1,1,1,4,1,8
986,1,2,3,0,2,8
987,1,3,3,0,1,8
988,3,4,1,0,0,8
989,5,1,1,0,1,8
990,4,1,2,0,1,8
991,1,4,1,1,1,8
992,6,0,0,2,0,8
993,2,1,2,2,1,8
994,3,0,1,4,0,8
995,4,1,1,1,1,8
996,3,0,1,0,4,8
997,2,2,2,1,1,8
998,1,3,1,1,2,8
999,2,1,1,3,1,8
1000,1,1,1,3,2,8
1001,5,1,1,0,1,8
1002,3,1,1,0,3,8
1003,3,2,1,1,1,8
1004,2,2,2,0,2,8
1005,4,1,1,0,2,8
1006,2,2,2,1,1,8
1007,1,2,2,0,3,8
1008,2,2,2,0,2,8
1009,8,0,0,0,0,8
1010,2,2,2,0,2,8
1011,3,1,1,2,1,8
1012,2,2,2,0,2,8
1013,2,2,1,1,2,8
1014,2,1,2,1,2,8
1015,2,1,1,3,1,8
1016,1,2,2,1,2,8
1017,4,1,1,1,1,8
1018,1,2,2,1,2,8
1019,3,1,1,1,2,8
1020,2,2,2,1,1,8
1021,2,2,2,0,2,8
1022,2,2,1,1,2,8
1023,2,2,2,1,1,8
1024,3,1,1,2,1,8
1025,2,1,1,2,2,8
1026,3,1,1,1,2,8
1027,2,1,1,2,2,8
1028,2,2,2,1,1,8
1029,2,2,2,0,2,8
1030,1,0,0,6,1,8
1031,1,2,2,1,2,8
1032,1,3,2,0,2,8
1033,2,1,2,2,1,8
1034,1,1,1,4,1,8
1035,2,2,1,1,2,8
1036,1,2,2,1,2,8
1037,2,2,1,1,2,8
1038,1,2,2,1,2,8
1039,4,2,1,0,1,8
1040,1,3,4,0,0,8
1041,1,1,1,4,1,8
1042,1,3,2,0,2,8
1043,1,1,2,3,1,8
1044,1,3,3,1,0,8
1045,1,2,2,1,2,8
1046,1,2,3,1,1,8
1047,0,5,3,0,0,8
1048,1,2,4,0,1,8
1049,1,1,1,3,2,8
1050,1,3,3,0,1,8
1051,3,2,1,1,1,8
1052,1,3,2,0,2,8
1053,1,4,0,0,3,8
1054,2,2,2,1,1,8
1055,1,2,2,0,3,8
1056,1,2,2,1,2,8
1057,1,2,1,1,3,8
1058,0,3,2,1,2,8
1059,0,2,2,1,3,8
1060,2,2,1,1,2,8
1061,1,2,2,1,2,8
1062,0,4,2,0,2,8
1063,1,2,1,3,1,8
1064,1,2,1,1,3,8
1065,0,2,3,1,2,8
1066,1,2,2,1,2,8
1067,1,2,2,1,2,8
1068,0,4,3,0,1,8
1069,1,3,1,0,3,8
1070,1,2,2,1,2,8
1071,1,2,2,1,2,8
1072,0,2,2,2,2,8
1073,2,3,1,0,2,8
1074,1,3,1,1,2,8
1075,1,2,2,0,3,8
1076,1,2,2,1,2,8
1077,0,3,2,1,2,8
1078,1,2,2,2,1,8
1079,1,1,4,1,1,8
1080,1,3,1,1,2,8
1081,1,0,1,6,0,8
1082,0,0,5,0,3,8
1083,0,0,1,7,0,8
1084,1,1,1,5,0,8
1085,1,0,0,6,1,8
1086,0,0,0,8,0,8
1087,0,0,0,5,3,8
1088,0,4,4,0,0,8
1089,0,3,3,0,2,8
1090,0,7,1,0,0,8
1091,0,6,1,0,1,8
1092,0,3,2,2,1,8
1093,0,3,2,1,2,8
1094,0,4,4,0,0,8
1095,0,3,4,0,1,8
1096,0,3,2,2,1,8
1097,0,0,2,6,0,8
1098,0,0,0,8,0,8
1099,0,0,0,8,0,8
1100,1,1,1,2,2,7
1101,2,1,1,0,3,7
1102,1,2,2,0,2,7
1103,1,3,1,1,1,7
1104,2,2,1,1,1,7
1105,1,2,2,0,2,7
1106,3,1,1,1,1,7
1107,1,2,2,1,1,7
1108,3,1,1,1,1,7
1109,7,0,0,0,0,7
1110,2,1,2,1,1,7
1111,1,1,1,3,1,7
1112,2,1,2,1,1,7
1113,2,1,1,2,1,7
1114,1,1,1,3,1,7
1115,2,2,1,0,2,7
1116,2,2,1,1,1,7
1117,1,1,1,2,2,7
1118,2,1,1,2,1,7
1119,2,1,1,2,1,7
1120,4,1,1,0,1,7
1121,1,2,2,0,2,7
1122,2,1,1,1,2,7
1123,2,2,2,0,1,7
1124,2,1,1,1,2,7
1125,4,1,2,0,0,7
1126,3,1,1,1,1,7
1127,1,3,1,1,1,7
1128,1,2,4,0,0,7
1129,3,1,1,1,1,7
1130,6,0,0,1,0,7
1131,1,1,1,1,3,7
1132,2,2,1,1,1,7
1133,1,0,0,6,0,7
1134,2,2,3,0,0,7
1135,1,2,1,2,1,7
1136,1,1,2,2,1,7
1137,2,1,1,2,1,7
1138,2,2,1,0,2,7
1139,1,2,1,2,1,7
1140,2,2,2,0,1,7
1141,1,2,1,1,2,7
1142,2,1,1,0,3,7
1143,3,1,1,1,1,7
1144,2,2,1,0,2,7
1145,1,3,2,1,0,7
1146,2,2,2,0,1,7
1147,5,0,0,1,1,7
1148,2,1,1,1,2,7
1149,2,2,1,1,1,7
1150,2,3,2,0,0,7
1151,5,1,0,0,1,7
1152,3,1,1,1,1,7
1153,2,2,2,0,1,7
1154,2,1,1,2,1,7
1155,3,1,2,0,1,7
1156,7,0,0,0,0,7
1157,1,1,2,1,2,7
1158,1,1,3,1,1,7
1159,1,1,1,3,1,7
1160,3,1,1,1,1,7
1161,3,1,1,1,1,7
1162,3,1,1,1,1,7
1163,3,1,1,1,1,7
1164,1,2,2,0,2,7
1165,1,1,2,1,2,7
1166,2,1,1,2,1,7
1167,1,1,1,2,2,7
1168,2,1,1,2,1,7
1169,1,2,2,1,1,7
1170,1,2,1,1,2,7
1171,1,2,1,1,2,7
1172,2,1,1,2,1,7
1173,3,1,1,0,2,7
1174,3,1,1,1,1,7
1175,1,3,2,0,1,7
1176,1,2,2,1,1,7
1177,2,1,1,2,1,7
1178,3,1,2,0,1,7
1179,3,1,1,1,1,7
1180,2,1,2,1,1,7
1181,3,1,1,1,1,7
1182,4,0,0,0,3,7
1183,2,1,2,1,1,7
1184,2,2,1,0,2,7
1185,2,1,1,2,1,7
1186,1,2,1,1,2,7
1187,2,2,1,1,1,7
1188,2,1,1,2,1,7
1189,4,1,1,0,1,7
1190,3,1,1,1,1,7
1191,6,0,0,0,1,7
1192,1,2,2,1,1,7
1193,2,1,1,2,1,7
1194,2,1,1,2,1,7
1195,2,1,1,1,2,7
1196,3,1,1,1,1,7
1197,1,2,1,2,1,7
1198,1,1,1,3,1,7
1199,1,2,2,0,2,7
1200,2,0,0,5,0,7
1201,2,1,1,2,1,7
1202,3,1,1,1,1,7
1203,2,2,0,2,1,7
1204,2,2,1,1,1,7
1205,1,1,1,3,1,7
1206,3,1,1,1,1,7
1207,3,1,1,1,1,7
1208,1,1,2,2,1,7
1209,2,1,1,1,2,7
1210,1,2,2,1,1,7
1211,1,2,1,2,1,7
1212,2,1,1,2,1,7
1213,3,2,2,0,0,7
1214,1,2,3,0,1,7
1215,3,2,1,0,1,7
1216,2,2,2,0,1,7
1217,2,0,0,5,0,7
1218,2,2,1,0,2,7
1219,1,1,3,0,2,7
1220,2,2,1,2,0,7
1221,1,2,2,0,2,7
1222,2,0,0,4,1,7
1223,1,2,4,0,0,7
1224,3,0,0,0,4,7
1225,2,2,1,0,2,7
1226,3,1,1,0,2,7
1227,1,2,1,1,2,7
1228,2,1,1,2,1,7
1229,2,1,1,2,1,7
1230,2,1,1,0,3,7
1231,1,2,1,1,2,7
1232,2,1,1,2,1,7
1233,2,2,1,1,1,7
1234,2,1,1,2,1,7
1235,1,2,2,1,1,7
1236,3,1,1,1,1,7
1237,2,2,2,0,1,7
1238,2,1,1,2,1,7
1239,2,1,1,2,1,7
1240,2,1,1,1,2,7
1241,2,1,2,1,1,7
1242,2,1,1,2,1,7
1243,2,1,1,1,2,7
1244,1,2,1,1,2,7
1245,1,2,2,1,1,7
1246,2,1,1,1,2,7
1247,1,2,2,0,2,7
1248,1,1,1,1,3,7
1249,1,0,0,6,0,7
1250,1,2,1,0,3,7
1251,2,2,1,0,2,7
1252,2,1,1,2,1,7
1253,2,2,1,2,0,7
1254,2,1,3,0,1,7
1255,2,2,1,1,1,7
1256,2,1,1,1,2,7
1257,2,2,1,1,1,7
1258,2,2,2,0,1,7
1259,1,1,1,3,1,7
1260,2,2,3,0,0,7
1261,2,2,1,1,1,7
1262,2,2,2,0,1,7
1263,2,2,1,1,1,7
1264,2,3,2,0,0,7
1265,2,2,2,0,1,7
1266,0,4,2,0,1,7
1267,1,2,2,0,2,7
1268,1,1,1,3,1,7
1269,1,1,2,1,2,7
1270,1,1,1,2,2,7
1271,1,1,1,2,2,7
1272,1,2,2,1,1,7
1273,1,1,1,3,1,7
1274,1,2,1,1,2,7
1275,1,1,2,0,3,7
1276,2,2,1,1,1,7
1277,0,2,1,0,4,7
1278,1,1,1,3,1,7
1279,1,2,2,0,2,7
1280,0,2,2,1,2,7
1281,2,1,1,2,1,7
1282,0,3,2,0,2,7
1283,1,1,1,2,2,7
1284,0,7,0,0,0,7
1285,1,1,1,3,1,7
1286,1,4,1,0,1,7
1287,1,2,2,1,1,7
1288,1,2,2,0,2,7
1289,2,2,2,0,1,7
1290,1,1,1,3,1,7
1291,1,2,2,0,2,7
1292,1,1,1,0,4,7
1293,2,2,1,1,1,7
1294,1,2,3,1,0,7
1295,1,2,1,2,1,7
1296,2,1,1,2,1,7
1297,1,2,1,1,2,7
1298,0,3,2,0,2,7
1299,0,2,2,1,2,7
1300,1,2,2,0,2,7
1301,1,2,1,1,2,7
1302,0,5,2,0,0,7
1303,1,1,3,0,2,7
1304,0,2,2,2,1,7
1305,1,2,2,0,2,7
1306,0,1,0,6,0,7
1307,1,2,1,1,2,7
1308,1,1,1,3,1,7
1309,1,1,2,2,1,7
1310,0,3,2,0,2,7
1311,0,1,4,1,1,7
1312,1,2,3,0,1,7
1313,1,2,2,0,2,7
1314,0,1,4,0,2,7
1315,1,1,1,2,2,7
1316,1,2,2,0,2,7
1317,1,1,1,3,1,7
1318,2,2,1,0,2,7
1319,1,2,1,1,2,7
1320,1,2,2,1,1,7
1321,1,3,1,1,1,7
1322,0,7,0,0,0,7
1323,2,1,1,1,2,7
1324,2,3,1,0,1,7
1325,2,3,1,0,1,7
1326,0,1,3,1,2,7
1327,1,2,2,1,1,7
1328,2,1,2,1,1,7
1329,0,2,3,0,2,7
1330,0,2,3,0,2,7
1331,0,0,0,7,0,7
1332,0,3,1,0,3,7
1333,0,0,0,0,7,7
1334,0,7,0,0,0,7
1335,0,3,3,0,1,7
1336,0,7,0,0,0,7
1337,0,5,2,0,0,7
1338,0,7,0,0,0,7
1339,0,3,4,0,0,7
1340,0,2,2,0,3,7
1341,0,2,2,0,3,7
1342,0,4,1,0,2,7
1343,0,2,2,1,2,7
1344,0,7,0,0,0,7
1345,0,6,0,0,1,7
1346,0,7,0,0,0,7
1347,0,7,0,0,0,7
1348,0,2,2,2,1,7
1349,0,2,2,1,2,7
1350,0,2,2,1,2,7
1351,0,2,2,0,3,7
1352,0,2,2,0,3,7
1353,0,2,2,1,2,7
1354,0,2,2,1,2,7
1355,0,5,2,0,0,7
1356,0,2,3,0,2,7
1357,0,0,7,0,0,7
1358,0,1,6,0,0,7
1359,0,0,0,0,7,7
1360,0,0,7,0,0,7
1361,0,0,0,7,0,7
1362,0,0,0,7,0,7
1363,0,0,0,0,7,7
1364,1,2,1,1,1,6
1365,1,3,2,0,0,6
1366,3,1,0,0,2,6
1367,2,1,1,1,1,6
1368,2,1,1,1,1,6
1369,1,1,1,1,2,6
1370,1,1,1,1,2,6
1371,1,2,1,1,1,6
1372,2,1,1,1,1,6
1373,2,1,1,1,1,6
1374,2,1,1,1,1,6
1375,2,1,1,1,1,6
1376,1,0,0,5,0,6
1377,2,1,1,1,1,6
1378,2,0,0,4,0,6
1379,2,1,1,1,1,6
1380,3,1,1,1,0,6
1381,2,3,1,0,0,6
1382,1,1,1,2,1,6
1383,2,2,2,0,0,6
1384,2,1,0,1,2,6
1385,2,1,1,1,1,6
1386,1,2,1,1,1,6
1387,1,3,1,0,1,6
1388,3,1,1,0,1,6
1389,1,1,3,0,1,6
1390,2,1,1,2,0,6
1391,2,1,1,1,1,6
1392,1,2,1,1,1,6
1393,2,1,1,1,1,6
1394,6,0,0,0,0,6
1395,4,0,0,0,2,6
1396,2,1,1,1,1,6
1397,2,1,1,1,1,6
1398,1,1,2,1,1,6
1399,2,2,1,0,1,6
1400,2,1,1,1,1,6
1401,1,2,1,1,1,6
1402,1,1,2,1,1,6
1403,3,1,1,1,0,6
1404,2,1,1,1,1,6
1405,2,1,1,1,1,6
1406,1,1,1,2,1,6
1407,2,1,1,1,1,6
1408,2,2,1,0,1,6
1409,2,1,1,1,1,6
1410,1,1,1,1,2,6
1411,6,0,0,0,0,6
1412,2,1,1,1,1,6
1413,3,0,0,1,2,6
1414,2,1,1,0,2,6
1415,6,0,0,0,0,6
1416,2,1,1,1,1,6
1417,2,0,0,4,0,6
1418,1,3,1,0,1,6
1419,2,0,2,0,2,6
1420,2,1,2,0,1,6
1421,2,0,1,3,0,6
1422,2,1,1,1,1,6
1423,1,1,1,2,1,6
1424,2,1,1,1,1,6
1425,2,1,1,1,1,6
1426,1,1,1,0,3,6
1427,1,1,1,1,2,6
1428,2,1,1,1,1,6
1429,6,0,0,0,0,6
1430,6,0,0,0,0,6
1431,2,1,1,1,1,6
1432,6,0,0,0,0,6
1433,2,1,1,1,1,6
1434,6,0,0,0,0,6
1435,6,0,0,0,0,6
1436,2,1,1,1,1,6
1437,6,0,0,0,0,6
1438,4,1,0,0,1,6
1439,2,1,1,1,1,6
1440,1,2,2,0,1,6
1441,2,1,1,1,1,6
1442,1,1,1,2,1,6
1443,1,1,1,1,2,6
1444,3,1,1,0,1,6
1445,1,1,1,2,1,6
1446,2,1,1,2,0,6
1447,2,1,1,1,1,6
1448,1,1,1,2,1,6
1449,1,1,1,2,1,6
1450,3,1,1,0,1,6
1451,2,1,1,1,1,6
1452,2,1,1,1,1,6
1453,2,1,1,1,1,6
1454,1,2,1,1,1,6
1455,2,1,1,1,1,6
1456,1,1,1,2,1,6
1457,1,0,0,5,0,6
1458,2,1,1,1,1,6
1459,2,1,1,1,1,6
1460,2,1,1,1,1,6
1461,2,1,1,1,1,6
1462,2,1,1,1,1,6
1463,1,2,2,0,1,6
1464,3,1,1,0,1,6
1465,2,2,1,0,1,6
1466,1,1,1,1,2,6
1467,4,1,0,0,1,6
1468,1,1,1,1,2,6
1469,1,2,1,1,1,6
1470,2,0,1,2,1,6
1471,4,0,0,2,0,6
1472,1,2,1,0,2,6
1473,1,1,2,1,1,6
1474,2,1,1,1,1,6
1475,1,1,1,2,1,6
1476,1,2,2,0,1,6
1477,1,2,2,0,1,6
1478,2,0,1,0,3,6
1479,2,1,1,1,1,6
1480,2,1,1,1,1,6
1481,4,1,1,0,0,6
1482,1,1,2,0,2,6
1483,1,1,1,1,2,6
1484,2,1,1,1,1,6
1485,2,1,2,1,0,6
1486,2,1,1,1,1,6
1487,1,1,1,2,1,6
1488,6,0,0,0,0,6
1489,2,1,1,2,0,6
1490,1,1,1,2,1,6
1491,2,1,1,0,2,6
1492,3,1,1,0,1,6
1493,1,1,1,2,1,6
1494,2,0,1,2,1,6
1495,2,1,1,1,1,6
1496,2,1,1,1,1,6
1497,2,1,1,1,1,6
1498,2,1,1,1,1,6
1499,1,1,2,1,1,6
1500,1,1,1,2,1,6
1501,2,1,0,1,2,6
1502,1,2,1,1,1,6
1503,2,1,2,0,1,6
1504,2,1,1,1,1,6
1505,1,0,0,5,0,6
1506,2,1,1,1,1,6
1507,1,1,2,1,1,6
1508,1,2,1,1,1,6
1509,2,1,1,1,1,6
1510,1,1,1,1,2,6
1511,2,1,1,1,1,6
1512,2,1,1,1,1,6
1513,1,1,1,2,1,6
1514,1,1,2,1,1,6
1515,2,2,1,0,1,6
1516,1,2,1,1,1,6
1517,2,1,1,1,1,6
1518,1,2,1,1,1,6
1519,1,1,2,1,1,6
1520,2,1,1,1,1,6
1521,2,0,0,4,0,6
1522,2,1,1,1,1,6
1523,2,1,1,1,1,6
1524,2,1,1,1,1,6
1525,1,1,1,2,1,6
1526,2,1,1,1,1,6
1527,2,1,1,1,1,6
1528,2,1,1,2,0,6
1529,2,1,1,1,1,6
1530,2,2,1,0,1,6
1531,2,1,1,1,1,6
1532,3,1,0,1,1,6
1533,1,1,1,1,2,6
1534,2,0,1,2,1,6
1535,1,2,1,1,1,6
1536,2,1,1,1,1,6
1537,2,1,1,1,1,6
1538,2,1,1,1,1,6
1539,1,2,1,0,2,6
1540,3,1,1,0,1,6
1541,1,1,1,2,1,6
1542,6,0,0,0,0,6
1543,2,1,1,1,1,6
1544,2,1,1,1,1,6
1545,2,1,1,1,1,6
1546,2,1,1,1,1,6
1547,1,2,1,2,0,6
1548,1,1,1,1,2,6
1549,1,2,1,0,2,6
1550,2,1,1,1,1,6
1551,2,1,1,2,0,6
1552,1,1,1,1,2,6
1553,2,1,1,1,1,6
1554,1,1,1,2,1,6
1555,1,1,1,2,1,6
1556,2,1,1,1,1,6
1557,1,1,1,1,2,6
1558,2,1,1,1,1,6
1559,2,1,1,1,1,6
1560,2,1,2,1,0,6
1561,2,2,1,0,1,6
1562,1,1,1,1,2,6
1563,2,1,1,1,1,6
1564,1,2,1,1,1,6
1565,1,1,2,1,1,6
1566,2,1,1,0,2,6
1567,2,1,1,1,1,6
1568,2,1,1,1,1,6
1569,2,1,1,1,1,6
1570,1,1,1,1,2,6
1571,6,0,0,0,0,6
1572,1,1,1,1,2,6
1573,1,1,1,2,1,6
1574,2,1,1,0,2,6
1575,3,1,1,0,1,6
1576,1,1,1,1,2,6
1577,2,1,1,1,1,6
1578,2,1,1,1,1,6
1579,3,1,1,0,1,6
1580,1,1,1,2,1,6
1581,1,1,1,2,1,6
1582,2,0,0,4,0,6
1583,2,1,1,1,1,6
1584,2,1,1,1,1,6
1585,2,1,1,1,1,6
1586,2,1,1,1,1,6
1587,2,1,1,1,1,6
1588,2,1,1,1,1,6
1589,1,1,1,2,1,6
1590,2,1,1,1,1,6
1591,2,1,1,1,1,6
1592,1,0,0,5,0,6
1593,2,1,1,1,1,6
1594,2,1,1,1,1,6
1595,1,1,1,2,1,6
1596,2,1,1,1,1,6
1597,2,1,1,1,1,6
1598,2,1,1,1,1,6
1599,2,1,1,0,2,6
1600,4,1,0,1,0,6
1601,1,1,1,1,2,6
1602,2,1,1,1,1,6
1603,2,1,1,1,1,6
1604,2,1,1,1,1,6
1605,2,1,1,1,1,6
1606,2,1,1,1,1,6
1607,2,1,1,1,1,6
1608,1,1,1,2,1,6
1609,3,0,0,2,1,6
1610,1,2,1,0,2,6
1611,2,1,1,1,1,6
1612,3,1,1,0,1,6
1613,1,3,1,0,1,6
1614,1,2,1,1,1,6
1615,2,1,1,1,1,6
1616,3,1,1,0,1,6
1617,2,1,1,1,1,6
1618,2,1,1,1,1,6
1619,1,1,1,1,2,6
1620,1,1,2,1,1,6
1621,2,1,1,1,1,6
1622,2,1,1,1,1,6
1623,2,1,1,1,1,6
1624,2,1,1,1,1,6
1625,2,1,1,0,2,6
1626,2,1,1,1,1,6
1627,3,1,1,0,1,6
1628,3,2,0,0,1,6
1629,2,1,1,0,2,6
1630,2,0,0,3,1,6
1631,2,1,1,1,1,6
1632,2,1,1,1,1,6
1633,2,1,1,1,1,6
1634,1,1,1,1,2,6
1635,1,1,1,2,1,6
1636,2,2,1,0,1,6
1637,2,1,1,1,1,6
1638,2,1,1,1,1,6
1639,2,1,1,1,1,6
1640,2,1,1,1,1,6
1641,2,1,1,1,1,6
1642,2,1,1,2,0,6
1643,2,1,1,1,1,6
1644,1,1,1,2,1,6
1645,1,2,1,1,1,6
1646,1,1,1,0,3,6
1647,0,2,2,0,2,6
1648,1,2,1,1,1,6
1649,1,2,1,1,1,6
1650,1,1,1,2,1,6
1651,1,1,1,1,2,6
1652,1,2,1,1,1,6
1653,1,1,1,1,2,6
1654,0,2,2,1,1,6
1655,1,2,3,0,0,6
1656,1,1,1,1,2,6
1657,1,1,1,2,1,6
1658,2,2,1,1,0,6
1659,1,1,1,1,2,6
1660,1,2,1,1,1,6
1661,1,1,1,2,1,6
1662,1,2,1,0,2,6
1663,1,1,2,2,0,6
1664,0,2,2,0,2,6
1665,1,1,1,2,1,6
1666,0,2,2,0,2,6
1667,1,2,2,0,1,6
1668,1,1,1,1,2,6
1669,1,1,1,1,2,6
1670,0,1,1,2,2,6
1671,0,2,2,0,2,6
1672,1,2,1,1,1,6
1673,1,1,1,1,2,6
1674,1,1,1,2,1,6
1675,2,2,1,0,1,6
1676,1,3,2,0,0,6
1677,1,1,1,1,2,6
1678,0,2,2,0,2,6
1679,1,2,1,1,1,6
1680,2,1,1,1,1,6
1681,1,1,1,1,2,6
1682,1,1,1,2,1,6
1683,1,1,1,1,2,6
1684,1,1,1,1,2,6
1685,1,1,1,1,2,6
1686,1,2,1,1,1,6
1687,2,1,1,1,1,6
1688,1,2,1,1,1,6
1689,1,5,0,0,0,6
1690,1,1,1,2,1,6
1691,1,1,1,1,2,6
1692,0,2,2,0,2,6
1693,1,2,1,0,2,6
1694,1,1,1,1,2,6
1695,0,3,1,1,1,6
1696,0,2,1,0,3,6
1697,1,1,1,2,1,6
1698,1,1,2,0,2,6
1699,1,1,1,1,2,6
1700,2,2,2,0,0,6
1701,1,2,1,0,2,6
1702,1,1,1,1,2,6
1703,1,1,2,1,1,6
1704,1,1,1,2,1,6
1705,1,2,1,1,1,6
1706,1,2,2,0,1,6
1707,1,2,1,1,1,6
1708,1,2,2,0,1,6
1709,0,2,2,1,1,6
1710,2,1,1,1,1,6
1711,1,1,1,2,1,6
1712,0,3,2,0,1,6
1713,1,1,1,2,1,6
1714,1,1,1,2,1,6
1715,1,2,1,0,2,6
1716,1,1,1,1,2,6
1717,1,2,2,0,1,6
1718,0,3,3,0,0,6
1719,2,1,1,1,1,6
1720,1,2,1,1,1,6
1721,1,1,1,2,1,6
1722,0,4,2,0,0,6
1723,1,2,1,1,1,6
1724,1,1,2,1,1,6
1725,1,1,1,1,2,6
1726,1,1,1,2,1,6
1727,1,2,1,0,2,6
1728,1,2,1,1,1,6
1729,1,1,1,2,1,6
1730,0,2,2,0,2,6
1731,1,1,1,1,2,6
1732,0,2,2,0,2,6
1733,1,1,1,2,1,6
1734,1,1,1,1,2,6
1735,2,1,1,1,1,6
1736,1,1,1,1,2,6
1737,2,1,1,1,1,6
1738,1,1,1,2,1,6
1739,2,1,1,1,1,6
1740,1,2,1,1,1,6
1741,1,2,1,0,2,6
1742,0,2,2,0,2,6
1743,1,3,2,0,0,6
1744,1,2,1,1,1,6
1745,1,3,1,0,1,6
1746,0,3,2,0,1,6
1747,1,3,1,0,1,6
1748,1,1,1,1,2,6
1749,2,1,1,1,1,6
1750,1,2,1,1,1,6
1751,1,1,2,1,1,6
1752,1,1,1,1,2,6
1753,2,2,2,0,0,6
1754,1,1,1,1,2,6
1755,1,1,1,1,2,6
1756,1,1,1,2,1,6
1757,1,1,1,1,2,6
1758,1,1,1,2,1,6
1759,1,1,1,1,2,6
1760,1,2,2,0,1,6
1761,1,1,1,1,2,6
1762,1,2,1,1,1,6
1763,1,2,1,1,1,6
1764,1,1,1,2,1,6
1765,0,1,1,0,4,6
1766,1,1,1,1,2,6
1767,1,1,1,0,3,6
1768,1,1,1,1,2,6
1769,1,1,1,1,2,6
1770,1,2,1,1,1,6
1771,1,1,1,1,2,6
1772,2,1,1,1,1,6
1773,0,2,1,2,1,6
1774,0,2,2,0,2,6
1775,1,1,1,2,1,6
1776,1,1,1,2,1,6
1777,1,1,2,1,1,6
1778,1,2,1,1,1,6
1779,1,2,1,0,2,6
1780,1,1,1,1,2,6
1781,1,1,1,1,2,6
1782,0,2,2,0,2,6
1783,1,1,1,2,1,6
1784,1,3,1,0,1,6
1785,1,1,1,2,1,6
1786,1,1,1,0,3,6
1787,1,2,1,0,2,6
1788,1,1,1,1,2,6
1789,1,2,1,1,1,6
1790,0,1,2,1,2,6
1791,1,2,1,1,1,6
1792,1,1,2,1,1,6
1793,1,2,1,1,1,6
1794,1,1,1,1,2,6
1795,1,2,1,0,2,6
1796,1,1,1,2,1,6
1797,1,1,1,2,1,6
1798,1,1,1,2,1,6
1799,1,2,1,1,1,6
1800,1,1,1,1,2,6
1801,1,2,1,1,1,6
1802,1,1,1,2,1,6
1803,1,2,1,1,1,6
1804,1,1,1,1,2,6
1805,0,2,2,1,1,6
1806,0,2,4,0,0,6
1807,2,1,1,1,1,6
1808,1,1,1,2,1,6
1809,1,1,1,1,2,6
1810,1,1,1,2,1,6
1811,1,2,1,1,1,6
1812,1,1,1,2,1,6
1813,1,1,1,1,2,6
1814,1,1,1,2,1,6
1815,1,1,1,2,1,6
1816,1,1,1,1,2,6
1817,1,1,1,2,1,6
1818,1,3,2,0,0,6
1819,2,2,1,1,0,6
1820,2,2,1,0,1,6
1821,1,2,1,0,2,6
1822,0,1,2,0,3,6
1823,0,1,1,1,3,6
1824,1,0,1,3,1,6
1825,0,1,1,3,1,6
1826,1,0,0,4,1,6
1827,0,0,0,6,0,6
1828,0,0,0,6,0,6
1829,0,0,0,6,0,6
1830,0,5,0,1,0,6
1831,1,1,1,2,1,6
1832,0,0,0,3,3,6
1833,0,0,0,0,6,6
1834,0,0,0,0,6,6
1835,0,1,1,3,1,6
1836,0,2,2,0,2,6
1837,0,3,2,0,1,6
1838,0,2,2,0,2,6
1839,0,2,1,0,3,6
1840,0,2,3,0,1,6
1841,0,5,0,0,1,6
1842,0,6,0,0,0,6
1843,0,6,0,0,0,6
1844,0,2,2,0,2,6
1845,0,2,2,2,0,6
1846,0,2,1,1,2,6
1847,0,2,2,0,2,6
1848,0,5,1,0,0,6
1849,0,2,2,0,2,6
1850,0,1,2,0,3,6
1851,0,2,1,1,2,6
1852,0,3,3,0,0,6
1853,0,3,1,0,2,6
1854,0,5,1,0,0,6
1855,0,2,2,0,2,6
1856,0,3,1,0,2,6
1857,0,4,2,0,0,6
1858,0,2,4,0,0,6
1859,0,4,1,0,1,6
1860,0,4,2,0,0,6
1861,0,6,0,0,0,6
1862,0,3,1,0,2,6
1863,0,1,5,0,0,6
1864,0,2,1,1,2,6
1865,0,1,5,0,0,6
1866,0,0,0,0,6,6
1867,0,0,6,0,0,6
1868,0,0,0,6,0,6
1869,0,0,0,6,0,6
1870,1,1,1,1,1,5
1871,1,1,1,1,1,5
1872,1,1,1,1,1,5
1873,1,1,1,1,1,5
1874,1,1,1,1,1,5
1875,1,1,1,1,1,5
1876,1,1,1,1,1,5
1877,1,1,1,1,1,5
1878,1,1,1,1,1,5
1879,1,1,1,1,1,5
1880,1,1,1,1,1,5
1881,1,2,1,0,1,5
1882,2,1,1,0,1,5
1883,1,1,1,1,1,5
1884,1,1,1,1,1,5
1885,1,1,1,1,1,5
1886,2,0,0,1,2,5
1887,5,0,0,0,0,5
1888,2,1,1,1,0,5
1889,1,1,1,1,1,5
1890,1,1,1,0,2,5
1891,1,1,1,1,1,5
1892,2,1,2,0,0,5
1893,3,0,0,1,1,5
1894,1,1,1,1,1,5
1895,2,1,1,1,0,5
1896,2,1,1,0,1,5
1897,1,1,1,1,1,5
1898,1,1,1,1,1,5
1899,1,1,1,1,1,5
1900,1,1,1,1,1,5
1901,1,1,1,1,1,5
1902,2,1,1,1,0,5
1903,1,1,1,1,1,5
1904,1,1,1,1,1,5
1905,1,1,1,1,1,5
1906,1,2,1,0,1,5
1907,1,1,1,1,1,5
1908,1,1,1,1,1,5
1909,2,1,1,1,0,5
1910,1,1,1,1,1,5
1911,1,1,1,1,1,5
1912,1,1,1,1,1,5
1913,2,1,1,1,0,5
1914,1,1,1,1,1,5
1915,2,1,1,1,0,5
1916,1,1,1,1,1,5
1917,1,1,1,1,1,5
1918,4,0,0,0,1,5
1919,1,1,1,1,1,5
1920,1,1,1,1,1,5
1921,2,1,1,0,1,5
1922,1,1,1,1,1,5
1923,1,1,1,0,2,5
1924,1,1,1,1,1,5
1925,1,1,1,1,1,5
1926,1,1,1,1,1,5
1927,1,1,1,1,1,5
1928,1,1,1,1,1,5
1929,1,1,1,1,1,5
1930,1,1,1,1,1,5
1931,1,1,1,1,1,5
1932,1,2,1,0,1,5
1933,2,1,1,0,1,5
1934,1,1,1,0,2,5
1935,1,1,1,1,1,5
1936,2,1,1,0,1,5
1937,1,1,1,1,1,5
1938,1,1,1,1,1,5
1939,1,1,2,0,1,5
1940,4,0,0,1,0,5
1941,1,1,1,1,1,5
1942,1,1,1,1,1,5
1943,1,1,1,1,1,5
1944,2,1,1,0,1,5
1945,1,0,2,0,2,5
1946,1,1,1,1,1,5
1947,1,1,1,1,1,5
1948,2,1,1,0,1,5
1949,2,1,1,1,0,5
1950,1,1,1,1,1,5
1951,2,1,1,0,1,5
1952,2,1,1,0,1,5
1953,1,1,1,1,1,5
1954,1,1,1,1,1,5
1955,1,1,1,1,1,5
1956,1,1,1,1,1,5
1957,1,1,1,1,1,5
1958,1,2,1,0,1,5
1959,1,2,1,1,0,5
1960,1,1,1,1,1,5
1961,1,1,1,1,1,5
1962,1,1,1,1,1,5
1963,1,1,1,1,1,5
1964,1,1,1,0,2,5
1965,1,1,1,0,2,5
1966,2,1,1,0,1,5
1967,1,1,1,0,2,5
1968,5,0,0,0,0,5
1969,2,1,1,0,1,5
1970,1,1,1,1,1,5
1971,1,1,1,1,1,5
1972,3,0,0,2,0,5
1973,2,1,1,0,1,5
1974,1,1,1,1,1,5
1975,2,1,2,0,0,5
1976,1,1,1,1,1,5
1977,2,1,1,1,0,5
1978,1,1,1,1,1,5
1979,5,0,0,0,0,5
1980,2,1,1,0,1,5
1981,1,1,1,0,2,5
1982,5,0,0,0,0,5
1983,1,1,1,1,1,5
1984,1,1,1,1,1,5
1985,1,1,1,1,1,5
1986,1,1,1,1,1,5
1987,1,1,1,1,1,5
1988,1,1,1,1,1,5
1989,1,1,1,1,1,5
1990,1,1,1,1,1,5
1991,1,1,1,1,1,5
1992,1,1,1,1,1,5
1993,1,1,1,1,1,5
1994,1,1,1,1,1,5
1995,1,1,1,1,1,5
1996,1,1,1,1,1,5
1997,1,1,1,0,2,5
1998,1,1,1,1,1,5
1999,1,1,1,1,1,5
2000,1,1,1,1,1,5
2001,1,1,1,1,1,5
2002,1,1,1,1,1,5
2003,1,1,1,1,1,5
2004,5,0,0,0,0,5
2005,2,0,0,1,2,5
2006,1,1,1,1,1,5
2007,1,1,1,1,1,5
2008,1,1,1,1,1,5
2009,1,1,1,1,1,5
2010,3,1,1,0,0,5
2011,1,1,1,0,2,5
2012,2,1,0,1,1,5
2013,1,2,1,1,0,5
2014,1,1,1,1,1,5
2015,5,0,0,0,0,5
2016,1,1,1,1,1,5
2017,1,1,1,1,1,5
2018,4,0,1,0,0,5
2019,1,1,1,1,1,5
2020,1,1,1,1,1,5
2021,2,1,1,0,1,5
2022,1,2,2,0,0,5
2023,1,2,2,0,0,5
2024,1,1,1,1,1,5
2025,1,1,1,1,1,5
2026,3,0,0,1,1,5
2027,2,1,1,1,0,5
2028,1,1,1,1,1,5
2029,3,0,2,0,0,5
2030,1,1,1,1,1,5
2031,1,1,1,1,1,5
2032,1,2,1,0,1,5
2033,1,1,1,0,2,5
2034,2,0,0,3,0,5
2035,1,1,1,1,1,5
2036,1,1,1,1,1,5
2037,5,0,0,0,0,5
2038,1,1,1,1,1,5
2039,5,0,0,0,0,5
2040,1,1,1,1,1,5
2041,1,1,1,1,1,5
2042,1,1,3,0,0,5
2043,5,0,0,0,0,5
2044,2,1,1,0,1,5
2045,1,1,1,1,1,5
2046,1,1,1,1,1,5
2047,1,1,1,1,1,5
2048,2,1,1,0,1,5
2049,1,1,1,1,1,5
2050,1,1,1,1,1,5
2051,1,1,1,1,1,5
2052,1,1,1,1,1,5
2053,1,1,1,1,1,5
2054,4,0,0,1,0,5
2055,1,1,1,1,1,5
2056,1,1,1,1,1,5
2057,1,1,1,1,1,5
2058,4,0,0,1,0,5
2059,2,1,1,0,1,5
2060,1,1,1,1,1,5
2061,1,1,1,1,1,5
2062,1,1,1,1,1,5
2063,1,1,1,1,1,5
2064,5,0,0,0,0,5
2065,1,1,2,0,1,5
2066,1,1,1,1,1,5
2067,1,1,1,1,1,5
2068,2,1,1,0,1,5
2069,1,1,1,1,1,5
2070,1,1,1,1,1,5
2071,1,1,1,1,1,5
2072,1,1,1,1,1,5
2073,1,1,1,1,1,5
2074,1,1,1,1,1,5
2075,1,1,1,1,1,5
2076,1,1,1,1,1,5
2077,1,2,1,0,1,5
2078,1,2,1,0,1,5
2079,1,2,1,0,1,5
2080,2,1,1,1,0,5
2081,1,1,1,1,1,5
2082,1,1,1,1,1,5
2083,4,0,0,1,0,5
2084,1,1,1,1,1,5
2085,1,1,1,1,1,5
2086,1,1,1,1,1,5
2087,1,1,1,1,1,5
2088,1,1,1,1,1,5
2089,1,1,1,1,1,5
2090,1,1,1,1,1,5
2091,1,1,1,1,1,5
2092,1,1,1,2,0,5
2093,1,1,1,1,1,5
2094,5,0,0,0,0,5
2095,1,1,1,1,1,5
2096,1,1,1,1,1,5
2097,1,1,1,1,1,5
2098,1,1,0,1,2,5
2099,1,1,1,1,1,5
2100,1,1,1,1,1,5
2101,1,1,1,1,1,5
2102,1,1,1,1,1,5
2103,1,1,1,1,1,5
2104,1,1,1,1,1,5
2105,1,1,1,1,1,5
2106,1,1,1,1,1,5
2107,1,1,1,1,1,5
2108,1,2,1,1,0,5
2109,1,1,1,1,1,5
2110,2,0,1,2,0,5
2111,4,0,0,1,0,5
2112,1,1,1,1,1,5
2113,1,1,1,1,1,5
2114,1,1,1,1,1,5
2115,1,1,1,1,1,5
2116,1,1,1,1,1,5
2117,2,1,2,0,0,5
2118,1,1,1,1,1,5
2119,1,1,1,1,1,5
2120,1,1,1,1,1,5
2121,1,1,1,0,2,5
2122,1,1,1,1,1,5
2123,1,1,1,1,1,5
2124,1,1,1,1,1,5
2125,1,1,1,1,1,5
2126,1,1,1,0,2,5
2127,1,1,1,1,1,5
2128,1,1,1,1,1,5
2129,1,1,1,1,1,5
2130,1,1,1,1,1,5
2131,1,1,1,1,1,5
2132,1,1,1,1,1,5
2133,1,1,1,1,1,5
2134,1,1,2,0,1,5
2135,1,1,1,0,2,5
2136,1,1,1,1,1,5
2137,1,1,1,1,1,5
2138,1,1,1,1,1,5
2139,1,1,2,0,1,5
2140,1,1,1,1,1,5
2141,1,1,1,1,1,5
2142,1,1,1,1,1,5
2143,1,1,1,1,1,5
2144,1,1,2,0,1,5
2145,2,1,1,0,1,5
2146,1,1,1,1,1,5
2147,1,1,1,1,1,5
2148,1,1,1,1,1,5
2149,1,1,1,1,1,5
2150,2,0,0,3,0,5
2151,1,1,1,1,1,5
2152,2,1,1,0,1,5
2153,1,1,1,0,2,5
2154,1,1,1,1,1,5
2155,1,1,2,0,1,5
2156,1,1,1,1,1,5
2157,1,1,1,1,1,5
2158,1,2,1,1,0,5
2159,1,1,1,1,1,5
2160,1,1,1,1,1,5
2161,1,1,1,1,1,5
2162,2,1,1,0,1,5
2163,1,1,1,1,1,5
2164,1,1,1,1,1,5
2165,5,0,0,0,0,5
2166,1,2,1,1,0,5
2167,1,1,1,1,1,5
2168,1,1,1,1,1,5
2169,1,1,1,1,1,5
2170,1,1,2,0,1,5
2171,1,1,1,1,1,5
2172,1,2,1,1,0,5
2173,1,1,1,1,1,5
2174,1,1,1,1,1,5
2175,1,1,1,1,1,5
2176,1,1,1,1,1,5
2177,2,1,1,0,1,5
2178,1,1,1,1,1,5
2179,1,2,1,0,1,5
2180,2,1,1,0,1,5
2181,1,1,1,1,1,5
2182,1,1,1,1,1,5
2183,2,1,1,0,1,5
2184,2,1,1,0,1,5
2185,1,1,1,1,1,5
2186,2,1,1,0,1,5
2187,2,1,1,0,1,5
2188,2,1,1,0,1,5
2189,1,1,1,1,1,5
2190,1,2,1,0,1,5
2191,1,1,1,1,1,5
2192,2,1,1,0,1,5
2193,2,1,1,0,1,5
2194,1,1,1,1,1,5
2195,2,1,1,0,1,5
2196,1,1,1,1,1,5
2197,1,1,1,1,1,5
2198,1,1,1,1,1,5
2199,1,2,1,1,0,5
2200,3,0,0,2,0,5
2201,1,1,1,1,1,5
2202,1,1,1,1,1,5
2203,1,1,1,0,2,5
2204,4,0,0,0,1,5
2205,1,1,1,1,1,5
2206,1,1,1,1,1,5
2207,1,1,1,1,1,5
2208,1,1,1,1,1,5
2209,1,1,1,1,1,5
2210,1,1,1,1,1,5
2211,1,1,1,1,1,5
2212,1,1,2,0,1,5
2213,1,1,1,0,2,5
2214,2,1,1,0,1,5
2215,1,1,1,1,1,5
2216,2,1,1,0,1,5
2217,1,1,1,1,1,5
2218,2,2,1,0,0,5
2219,2,1,1,0,1,5
2220,1,1,1,1,1,5
2221,1,1,1,1,1,5
2222,1,1,1,1,1,5
2223,2,1,1,0,1,5
2224,1,1,1,1,1,5
2225,1,1,1,1,1,5
2226,1,1,1,0,2,5
2227,1,1,1,1,1,5
2228,1,1,1,1,1,5
2229,2,1,1,0,1,5
2230,1,1,1,1,1,5
2231,2,1,1,0,1,5
2232,3,0,1,0,1,5
2233,2,1,1,1,0,5
2234,1,1,1,1,1,5
2235,1,1,1,1,1,5
2236,1,1,1,1,1,5
2237,1,1,1,1,1,5
2238,1,1,1,1,1,5
2239,2,1,1,1,0,5
2240,1,1,1,1,1,5
2241,1,1,1,1,1,5
2242,1,1,1,1,1,5
2243,1,1,1,1,1,5
2244,1,1,1,1,1,5
2245,1,1,1,1,1,5
2246,1,2,1,0,1,5
2247,1,2,1,0,1,5
2248,1,1,1,1,1,5
2249,1,1,1,1,1,5
2250,1,1,1,1,1,5
2251,1,1,1,1,1,5
2252,1,2,1,0,1,5
2253,1,1,1,1,1,5
2254,1,1,1,1,1,5
2255,1,1,1,1,1,5
2256,2,1,0,1,1,5
2257,1,1,1,1,1,5
2258,1,1,1,1,1,5
2259,1,1,1,1,1,5
2260,3,1,1,0,0,5
2261,1,1,1,1,1,5
2262,1,1,1,1,1,5
2263,1,1,1,1,1,5
2264,1,1,1,1,1,5
2265,4,0,0,1,0,5
2266,1,1,1,1,1,5
2267,4,0,0,0,1,5
2268,1,1,1,1,1,5
2269,1,1,1,1,1,5
2270,1,1,1,1,1,5
2271,1,1,1,1,1,5
2272,1,1,1,1,1,5
2273,1,1,1,2,0,5
2274,1,1,1,1,1,5
2275,3,0,0,2,0,5
2276,1,1,1,1,1,5
2277,1,1,1,1,1,5
2278,1,1,1,1,1,5
2279,1,1,1,1,1,5
2280,1,1,1,0,2,5
2281,1,1,1,1,1,5
2282,1,1,1,1,1,5
2283,1,2,1,0,1,5
2284,1,1,1,1,1,5
2285,1,1,1,1,1,5
2286,1,0,1,3,0,5
2287,2,1,1,1,0,5
2288,1,1,1,1,1,5
2289,2,1,1,0,1,5
2290,1,1,1,1,1,5
2291,1,1,1,1,1,5
2292,1,1,1,1,1,5
2293,1,1,1,1,1,5
2294,2,1,1,0,1,5
2295,1,1,1,1,1,5
2296,1,1,1,1,1,5
2297,2,1,1,0,1,5
2298,1,0,0,3,1,5
2299,1,1,1,1,1,5
2300,1,1,1,1,1,5
2301,2,1,1,0,1,5
2302,1,1,1,1,1,5
2303,4,0,1,0,0,5
2304,2,1,1,0,1,5
2305,2,1,1,0,1,5
2306,2,1,1,0,1,5
2307,1,1,1,1,1,5
2308,1,1,1,1,1,5
2309,2,0,0,0,3,5
2310,1,1,1,1,1,5
2311,1,1,1,1,1,5
2312,1,1,1,1,1,5
2313,2,1,1,0,1,5
2314,2,1,1,0,1,5
2315,2,0,1,1,1,5
2316,5,0,0,0,0,5
2317,1,1,1,1,1,5
2318,2,1,1,0,1,5
2319,5,0,0,0,0,5
2320,1,1,1,1,1,5
2321,2,0,0,0,3,5
2322,1,1,1,1,1,5
2323,1,1,1,1,1,5
2324,5,0,0,0,0,5
2325,1,1,1,1,1,5
2326,1,1,1,1,1,5
2327,1,1,1,1,1,5
2328,1,1,1,1,1,5
2329,1,2,1,0,1,5
2330,2,1,1,1,0,5
2331,1,1,1,1,1,5
2332,2,1,1,0,1,5
2333,1,1,1,1,1,5
2334,2,1,1,0,1,5
2335,1,1,1,1,1,5
2336,5,0,0,0,0,5
2337,1,2,1,0,1,5
2338,1,1,1,1,1,5
2339,1,1,1,1,1,5
2340,1,1,1,1,1,5
2341,1,1,1,1,1,5
2342,1,1,1,1,1,5
2343,3,0,0,0,2,5
2344,1,1,1,1,1,5
2345,1,1,1,1,1,5
2346,1,1,1,1,1,5
2347,1,2,2,0,0,5
2348,1,1,1,1,1,5
2349,1,1,1,1,1,5
2350,2,1,1,0,1,5
2351,1,1,1,1,1,5
2352,1,1,1,1,1,5
2353,2,0,1,1,1,5
2354,1,1,1,1,1,5
2355,3,0,1,0,1,5
2356,1,1,1,1,1,5
2357,1,1,1,1,1,5
2358,1,1,1,1,1,5
2359,1,1,1,1,1,5
2360,1,2,1,1,0,5
2361,2,1,1,0,1,5
2362,1,1,1,1,1,5
2363,2,1,1,0,1,5
2364,1,1,1,1,1,5
2365,1,1,1,1,1,5
2366,3,1,1,0,0,5
2367,1,1,1,1,1,5
2368,1,1,1,1,1,5
2369,1,1,1,1,1,5
2370,1,1,1,1,1,5
2371,1,1,1,1,1,5
2372,1,1,1,1,1,5
2373,1,1,1,1,1,5
2374,1,1,1,1,1,5
2375,1,1,1,1,1,5
2376,1,1,1,1,1,5
2377,1,1,1,1,1,5
2378,1,1,1,1,1,5
2379,1,1,1,1,1,5
2380,1,1,1,1,1,5
2381,1,1,1,0,2,5
2382,1,1,1,1,1,5
2383,5,0,0,0,0,5
2384,1,1,1,1,1,5
2385,1,1,1,1,1,5
2386,5,0,0,0,0,5
2387,1,1,1,1,1,5
2388,1,1,1,1,1,5
2389,1,1,1,1,1,5
2390,3,0,0,2,0,5
2391,1,1,1,1,1,5
2392,1,1,1,1,1,5
2393,1,1,1,1,1,5
2394,1,1,1,1,1,5
2395,1,1,1,1,1,5
2396,1,1,1,1,1,5
2397,2,0,0,2,1,5
2398,1,1,1,1,1,5
2399,1,1,1,1,1,5
2400,2,1,1,0,1,5
2401,2,1,1,0,1,5
2402,1,1,1,1,1,5
2403,1,1,1,1,1,5
2404,1,1,1,1,1,5
2405,1,1,1,1,1,5
2406,1,1,1,1,1,5
2407,1,1,1,1,1,5
2408,1,1,1,1,1,5
2409,1,1,1,1,1,5
2410,1,1,1,1,1,5
2411,1,1,1,1,1,5
2412,1,2,1,0,1,5
2413,1,1,1,1,1,5
2414,1,1,1,1,1,5
2415,1,1,1,1,1,5
2416,1,1,1,1,1,5
2417,1,1,1,1,1,5
2418,1,1,1,1,1,5
2419,1,1,1,1,1,5
2420,1,1,1,1,1,5
2421,1,1,1,1,1,5
2422,3,1,0,0,1,5
2423,2,1,1,0,1,5
2424,1,1,1,1,1,5
2425,1,1,1,1,1,5
2426,2,1,1,0,1,5
2427,1,1,1,1,1,5
2428,2,1,1,0,1,5
2429,1,1,1,0,2,5
2430,1,1,1,1,1,5
2431,2,1,1,0,1,5
2432,1,1,1,1,1,5
2433,1,1,1,1,1,5
2434,1,1,1,1,1,5
2435,1,1,1,1,1,5
2436,1,1,1,1,1,5
2437,1,1,1,1,1,5
2438,1,1,1,1,1,5
2439,1,1,1,1,1,5
2440,1,1,1,1,1,5
2441,4,0,0,1,0,5
2442,2,1,1,0,1,5
2443,2,1,1,0,1,5
2444,1,1,1,1,1,5
2445,1,1,1,1,1,5
2446,1,1,1,1,1,5
2447,1,1,1,1,1,5
2448,1,1,1,1,1,5
2449,1,1,1,2,0,5
2450,1,1,1,1,1,5
2451,1,1,1,0,2,5
2452,1,1,2,1,0,5
2453,2,1,1,1,0,5
2454,1,1,1,1,1,5
2455,1,1,1,1,1,5
2456,2,1,1,0,1,5
2457,1,1,1,1,1,5
2458,2,1,1,0,1,5
2459,1,1,1,1,1,5
2460,1,1,1,1,1,5
2461,1,1,1,1,1,5
2462,1,1,1,1,1,5
2463,2,1,1,0,1,5
2464,1,1,1,1,1,5
2465,1,1,1,1,1,5
2466,1,1,1,1,1,5
2467,1,1,1,1,1,5
2468,1,1,1,1,1,5
2469,1,1,1,1,1,5
2470,1,1,1,1,1,5
2471,1,1,1,1,1,5
2472,1,1,1,1,1,5
2473,1,1,1,1,1,5
2474,1,1,1,1,1,5
2475,1,1,1,1,1,5
2476,1,1,1,1,1,5
2477,2,1,1,0,1,5
2478,1,1,1,1,1,5
2479,1,1,1,1,1,5
2480,1,1,1,1,1,5
2481,1,1,1,0,2,5
2482,1,1,1,1,1,5
2483,1,1,1,1,1,5
2484,1,1,1,1,1,5
2485,2,1,1,1,0,5
2486,2,1,1,0,1,5
2487,1,1,1,1,1,5
2488,1,1,1,1,1,5
2489,1,1,1,1,1,5
2490,5,0,0,0,0,5
2491,1,1,1,1,1,5
2492,3,0,0,2,0,5
2493,1,1,1,1,1,5
2494,5,0,0,0,0,5
2495,1,1,1,1,1,5
2496,1,1,1,1,1,5
2497,1,1,1,1,1,5
2498,1,1,1,1,1,5
2499,1,1,1,1,1,5
2500,1,1,1,1,1,5
2501,0,1,3,0,1,5
2502,1,1,1,1,1,5
2503,1,1,1,1,1,5
2504,1,1,1,1,1,5
2505,1,1,1,1,1,5
2506,1,1,1,1,1,5
2507,1,1,1,1,1,5
2508,1,1,1,1,1,5
2509,1,1,1,1,1,5
2510,1,1,1,1,1,5
2511,1,1,1,1,1,5
2512,1,1,1,1,1,5
2513,0,3,1,0,1,5
2514,1,1,1,1,1,5
2515,1,1,1,1,1,5
2516,1,1,1,1,1,5
2517,1,1,1,1,1,5
2518,1,1,1,1,1,5
2519,1,1,1,1,1,5
2520,1,2,1,0,1,5
2521,1,1,1,1,1,5
2522,1,1,1,2,0,5
2523,1,1,1,1,1,5
2524,1,1,1,1,1,5
2525,1,1,1,1,1,5
2526,1,1,1,1,1,5
2527,0,2,1,1,1,5
2528,1,1,1,1,1,5
2529,1,1,1,1,1,5
2530,1,1,1,1,1,5
2531,1,1,1,1,1,5
2532,1,1,1,1,1,5
2533,1,1,1,1,1,5
2534,1,1,1,1,1,5
2535,1,1,1,1,1,5
2536,1,1,2,0,1,5
2537,1,1,1,1,1,5
2538,1,1,1,1,1,5
2539,1,1,1,1,1,5
2540,1,1,1,1,1,5
2541,0,2,1,1,1,5
2542,1,1,1,1,1,5
2543,1,1,1,1,1,5
2544,2,1,1,0,1,5
2545,1,1,1,1,1,5
2546,1,1,1,1,1,5
2547,1,1,1,1,1,5
2548,1,1,1,1,1,5
2549,1,1,1,1,1,5
2550,1,1,1,1,1,5
2551,1,1,1,1,1,5
2552,1,1,1,1,1,5
2553,1,1,1,1,1,5
2554,1,1,1,1,1,5
2555,1,1,1,1,1,5
2556,1,1,1,1,1,5
2557,1,1,1,1,1,5
2558,1,1,1,1,1,5
2559,1,1,1,1,1,5
2560,1,1,1,1,1,5
2561,1,1,1,1,1,5
2562,1,1,1,1,1,5
2563,1,1,1,1,1,5
2564,1,1,1,1,1,5
2565,0,2,2,0,1,5
2566,1,1,1,1,1,5
2567,1,1,1,1,1,5
2568,1,1,1,1,1,5
2569,1,1,1,1,1,5
2570,1,1,1,1,1,5
2571,0,3,1,1,0,5
2572,1,1,1,1,1,5
2573,1,1,1,1,1,5
2574,1,1,1,1,1,5
2575,1,1,1,1,1,5
2576,1,1,1,1,1,5
2577,1,1,1,1,1,5
2578,1,1,1,1,1,5
2579,1,1,1,1,1,5
2580,1,1,1,1,1,5
2581,0,2,1,0,2,5
2582,1,1,1,1,1,5
2583,1,1,1,1,1,5
2584,1,1,1,1,1,5
2585,1,2,2,0,0,5
2586,1,1,1,1,1,5
2587,1,1,1,1,1,5
2588,1,1,1,1,1,5
2589,1,1,1,1,1,5
2590,1,1,1,1,1,5
2591,1,1,1,1,1,5
2592,1,1,1,1,1,5
2593,1,1,1,1,1,5
2594,1,1,0,1,2,5
2595,1,1,1,1,1,5
2596,1,1,1,1,1,5
2597,1,1,1,1,1,5
2598,1,1,1,1,1,5
2599,1,1,1,1,1,5
2600,1,1,1,1,1,5
2601,1,1,1,1,1,5
2602,1,1,1,1,1,5
2603,1,1,1,1,1,5
2604,1,1,1,1,1,5
2605,0,3,1,0,1,5
2606,1,1,1,1,1,5
2607,1,2,1,0,1,5
2608,0,3,1,0,1,5
2609,1,1,1,1,1,5
2610,1,1,1,1,1,5
2611,1,1,1,1,1,5
2612,2,1,1,0,1,5
2613,1,1,1,1,1,5
2614,1,1,1,1,1,5
2615,1,1,1,1,1,5
2616,0,1,1,3,0,5
2617,1,1,1,1,1,5
2618,1,1,1,1,1,5
2619,1,1,1,1,1,5
2620,1,1,1,1,1,5
2621,1,1,1,1,1,5
2622,1,1,1,1,1,5
2623,1,1,1,1,1,5
2624,1,1,1,1,1,5
2625,1,2,1,0,1,5
2626,1,1,1,1,1,5
2627,1,1,1,1,1,5
2628,1,1,1,1,1,5
2629,1,1,1,1,1,5
2630,1,1,1,1,1,5
2631,1,1,1,1,1,5
2632,1,1,1,1,1,5
2633,1,1,1,1,1,5
2634,1,1,1,1,1,5
2635,1,1,1,1,1,5
2636,1,1,1,1,1,5
2637,1,2,1,0,1,5
2638,1,1,1,1,1,5
2639,1,1,1,1,1,5
2640,1,1,1,1,1,5
2641,1,1,1,0,2,5
2642,1,1,1,1,1,5
2643,1,1,1,1,1,5
2644,1,1,1,1,1,5
2645,1,1,1,1,1,5
2646,1,1,1,1,1,5
2647,1,1,1,1,1,5
2648,1,1,1,1,1,5
2649,1,2,1,0,1,5
2650,1,1,1,1,1,5
2651,1,1,1,1,1,5
2652,1,2,1,0,1,5
2653,1,1,1,1,1,5
2654,1,1,1,1,1,5
2655,1,1,1,1,1,5
2656,1,1,1,1,1,5
2657,1,1,1,1,1,5
2658,1,1,1,1,1,5
2659,1,1,1,1,1,5
2660,1,2,1,1,0,5
2661,1,1,1,1,1,5
2662,1,2,1,1,0,5
2663,1,1,1,1,1,5
2664,1,1,1,1,1,5
2665,1,1,1,1,1,5
2666,1,1,1,1,1,5
2667,1,1,1,1,1,5
2668,1,1,1,1,1,5
2669,1,1,1,1,1,5
2670,1,1,1,1,1,5
2671,0,3,2,0,0,5
2672,1,1,1,1,1,5
2673,1,1,1,1,1,5
2674,1,1,1,1,1,5
2675,1,1,1,1,1,5
2676,1,2,1,0,1,5
2677,1,1,1,1,1,5
2678,1,1,1,0,2,5
2679,1,1,1,1,1,5
2680,1,1,1,1,1,5
2681,1,1,1,1,1,5
2682,1,1,1,1,1,5
2683,1,1,1,1,1,5
2684,1,1,1,1,1,5
2685,1,1,1,1,1,5
2686,1,1,1,1,1,5
2687,1,1,1,0,2,5
2688,1,1,1,0,2,5
2689,1,1,1,1,1,5
2690,1,1,1,1,1,5
2691,1,1,1,1,1,5
2692,1,1,1,1,1,5
2693,1,1,1,1,1,5
2694,1,1,1,1,1,5
2695,1,1,1,1,1,5
2696,1,1,1,1,1,5
2697,1,1,1,1,1,5
2698,1,1,1,1,1,5
2699,1,1,1,1,1,5
2700,1,1,1,1,1,5
2701,1,1,1,1,1,5
2702,1,1,1,1,1,5
2703,1,1,1,1,1,5
2704,1,1,1,1,1,5
2705,1,1,1,1,1,5
2706,1,1,1,1,1,5
2707,1,1,1,1,1,5
2708,1,1,1,1,1,5
2709,1,1,1,1,1,5
2710,1,1,1,1,1,5
2711,1,1,1,1,1,5
2712,1,1,1,1,1,5
2713,1,1,1,1,1,5
2714,1,1,1,1,1,5
2715,1,1,1,1,1,5
2716,1,1,1,1,1,5
2717,1,1,1,1,1,5
2718,1,1,1,1,1,5
2719,1,1,1,1,1,5
2720,1,1,1,1,1,5
2721,1,1,1,1,1,5
2722,1,1,1,1,1,5
2723,1,1,1,1,1,5
2724,1,1,1,1,1,5
2725,1,1,1,1,1,5
2726,1,1,1,1,1,5
2727,1,1,1,1,1,5
2728,1,1,1,0,2,5
2729,1,1,1,1,1,5
2730,1,1,1,1,1,5
2731,1,1,1,1,1,5
2732,1,1,1,1,1,5
2733,1,1,1,1,1,5
2734,1,1,1,1,1,5
2735,1,1,1,1,1,5
2736,1,1,1,1,1,5
2737,1,1,1,1,1,5
2738,1,2,1,0,1,5
2739,1,1,1,1,1,5
2740,1,1,1,1,1,5
2741,0,2,1,0,2,5
2742,1,1,0,2,1,5
2743,1,2,1,0,1,5
2744,1,1,1,0,2,5
2745,0,1,2,1,1,5
2746,0,2,2,0,1,5
2747,1,1,1,1,1,5
2748,1,1,1,1,1,5
2749,1,1,1,1,1,5
2750,1,2,1,0,1,5
2751,1,1,1,1,1,5
2752,1,1,1,1,1,5
2753,1,1,1,1,1,5
2754,1,1,1,1,1,5
2755,1,1,1,1,1,5
2756,1,1,1,1,1,5
2757,1,1,1,1,1,5
2758,1,1,1,1,1,5
2759,1,1,1,1,1,5
2760,1,1,1,1,1,5
2761,1,1,1,1,1,5
2762,1,2,1,0,1,5
2763,1,1,1,1,1,5
2764,1,1,1,1,1,5
2765,1,1,1,1,1,5
2766,1,1,1,1,1,5
2767,1,1,1,1,1,5
2768,1,1,1,1,1,5
2769,1,1,1,1,1,5
2770,1,1,2,0,1,5
2771,0,3,2,0,0,5
2772,1,1,1,1,1,5
2773,1,1,1,1,1,5
2774,1,1,1,1,1,5
2775,1,1,1,1,1,5
2776,1,1,1,1,1,5
2777,1,1,1,1,1,5
2778,1,1,1,1,1,5
2779,1,2,1,0,1,5
2780,0,1,1,0,3,5
2781,1,1,1,1,1,5
2782,1,1,1,1,1,5
2783,1,1,1,1,1,5
2784,1,1,1,1,1,5
2785,1,1,1,0,2,5
2786,1,1,1,1,1,5
2787,1,1,1,1,1,5
2788,1,1,1,1,1,5
2789,1,1,1,1,1,5
2790,1,1,1,1,1,5
2791,1,1,1,1,1,5
2792,1,1,1,1,1,5
2793,1,1,1,1,1,5
2794,1,2,2,0,0,5
2795,0,1,1,1,2,5
2796,1,1,1,1,1,5
2797,1,1,1,1,1,5
2798,1,1,1,0,2,5
2799,1,1,1,1,1,5
2800,1,1,1,1,1,5
2801,1,1,1,1,1,5
2802,1,1,1,1,1,5
2803,1,1,1,1,1,5
2804,1,1,1,1,1,5
2805,1,2,1,0,1,5
2806,1,1,1,1,1,5
2807,1,3,1,0,0,5
2808,1,1,1,1,1,5
2809,1,1,1,1,1,5
2810,1,1,1,1,1,5
2811,1,1,1,1,1,5
2812,1,1,1,1,1,5
2813,1,1,1,1,1,5
2814,1,1,1,1,1,5
2815,1,1,1,1,1,5
2816,1,1,1,1,1,5
2817,2,1,1,0,1,5
2818,1,1,1,1,1,5
2819,1,1,1,1,1,5
2820,1,1,1,1,1,5
2821,1,1,1,1,1,5
2822,1,1,1,1,1,5
2823,1,1,1,1,1,5
2824,1,1,1,1,1,5
2825,1,1,1,1,1,5
2826,1,1,1,1,1,5
2827,1,1,1,1,1,5
2828,1,1,1,1,1,5
2829,1,2,1,0,1,5
2830,1,1,1,1,1,5
2831,1,1,1,1,1,5
2832,1,1,1,1,1,5
2833,1,1,1,1,1,5
2834,1,1,1,1,1,5
2835,1,1,1,1,1,5
2836,1,1,1,1,1,5
2837,1,1,2,1,0,5
2838,1,1,2,0,1,5
2839,1,1,1,1,1,5
2840,1,1,1,1,1,5
2841,1,1,1,1,1,5
2842,1,1,1,1,1,5
2843,1,1,1,1,1,5
2844,1,1,1,0,2,5
2845,1,1,1,1,1,5
2846,0,2,1,0,2,5
2847,1,1,1,1,1,5
2848,1,1,1,1,1,5
2849,1,1,1,1,1,5
2850,1,1,1,1,1,5
2851,1,1,1,1,1,5
2852,1,1,1,1,1,5
2853,1,1,1,0,2,5
2854,1,1,1,1,1,5
2855,1,1,1,1,1,5
2856,1,1,1,1,1,5
2857,1,1,1,1,1,5
2858,1,1,1,1,1,5
2859,1,1,1,1,1,5
2860,1,1,1,1,1,5
2861,1,1,1,1,1,5
2862,1,1,1,1,1,5
2863,1,1,1,1,1,5
2864,1,1,1,1,1,5
2865,1,1,1,1,1,5
2866,1,1,1,1,1,5
2867,1,1,1,1,1,5
2868,1,1,1,1,1,5
2869,1,1,1,1,1,5
2870,1,1,1,1,1,5
2871,1,1,1,1,1,5
2872,1,2,1,0,1,5
2873,1,1,1,1,1,5
2874,1,1,1,1,1,5
2875,1,1,1,1,1,5
2876,1,1,1,1,1,5
2877,1,2,1,0,1,5
2878,1,1,1,1,1,5
2879,1,1,1,1,1,5
2880,1,1,1,1,1,5
2881,1,1,1,1,1,5
2882,1,1,1,1,1,5
2883,1,2,2,0,0,5
2884,1,2,1,0,1,5
2885,1,2,1,1,0,5
2886,1,1,1,0,2,5
2887,1,1,1,1,1,5
2888,1,1,1,1,1,5
2889,1,1,1,1,1,5
2890,1,1,1,1,1,5
2891,1,1,1,1,1,5
2892,1,1,1,1,1,5
2893,1,1,1,1,1,5
2894,1,1,1,1,1,5
2895,1,1,1,1,1,5
2896,1,1,1,1,1,5
2897,1,1,1,0,2,5
2898,1,1,1,1,1,5
2899,1,1,1,1,1,5
2900,1,1,1,1,1,5
2901,1,1,1,1,1,5
2902,1,1,1,1,1,5
2903,1,1,1,1,1,5
2904,1,1,1,1,1,5
2905,1,1,1,1,1,5
2906,1,1,1,1,1,5
2907,1,1,1,1,1,5
2908,1,1,1,1,1,5
2909,1,1,1,1,1,5
2910,1,1,1,1,1,5
2911,1,1,1,1,1,5
2912,1,1,1,1,1,5
2913,1,1,1,1,1,5
2914,1,1,1,1,1,5
2915,1,1,1,1,1,5
2916,2,1,1,0,1,5
2917,1,1,1,1,1,5
2918,1,1,1,1,1,5
2919,1,1,1,1,1,5
2920,1,1,1,1,1,5
2921,0,1,3,0,1,5
2922,1,1,1,1,1,5
2923,0,2,1,0,2,5
2924,0,2,1,1,1,5
2925,1,1,1,1,1,5
2926,1,1,1,1,1,5
2927,1,1,1,1,1,5
2928,1,1,1,1,1,5
2929,1,1,1,1,1,5
2930,1,1,1,1,1,5
2931,1,1,1,1,1,5
2932,1,1,1,1,1,5
2933,1,1,1,1,1,5
2934,1,1,1,1,1,5
2935,1,1,1,1,1,5
2936,1,1,1,1,1,5
2937,1,1,1,1,1,5
2938,1,1,1,1,1,5
2939,1,1,1,1,1,5
2940,1,1,1,1,1,5
2941,1,1,1,1,1,5
2942,1,1,1,1,1,5
2943,1,1,1,1,1,5
2944,1,1,1,1,1,5
2945,1,1,1,1,1,5
2946,1,1,1,1,1,5
2947,1,1,1,1,1,5
2948,1,1,1,1,1,5
2949,1,1,1,1,1,5
2950,1,1,1,1,1,5
2951,1,1,1,1,1,5
2952,1,1,1,1,1,5
2953,1,1,1,1,1,5
2954,1,1,1,1,1,5
2955,1,1,1,1,1,5
2956,1,1,1,1,1,5
2957,1,1,1,0,2,5
2958,1,1,1,1,1,5
2959,1,1,1,1,1,5
2960,1,1,1,1,1,5
2961,1,1,1,1,1,5
2962,1,1,1,1,1,5
2963,1,1,1,1,1,5
2964,1,1,1,1,1,5
2965,1,1,1,1,1,5
2966,1,1,1,1,1,5
2967,1,1,1,1,1,5
2968,1,1,1,1,1,5
2969,1,1,1,1,1,5
2970,1,1,1,1,1,5
2971,1,1,1,1,1,5
2972,1,1,1,1,1,5
2973,1,1,1,1,1,5
2974,1,1,1,1,1,5
2975,1,2,1,0,1,5
2976,1,1,1,1,1,5
2977,1,1,1,1,1,5
2978,1,1,1,1,1,5
2979,1,1,1,1,1,5
2980,1,1,1,1,1,5
2981,1,1,1,1,1,5
2982,1,1,1,1,1,5
2983,1,1,1,1,1,5
2984,2,1,1,0,1,5
2985,1,1,1,1,1,5
2986,1,1,1,1,1,5
2987,1,1,1,1,1,5
2988,1,1,1,1,1,5
2989,1,1,1,1,1,5
2990,1,1,1,1,1,5
2991,1,1,1,1,1,5
2992,1,1,1,1,1,5
2993,1,1,1,1,1,5
2994,1,1,1,1,1,5
2995,1,1,1,1,1,5
2996,1,1,1,1,1,5
2997,1,1,1,1,1,5
2998,1,1,1,1,1,5
2999,1,1,1,1,1,5
3000,0,1,1,0,3,5
3001,1,1,1,1,1,5
3002,1,1,1,1,1,5
3003,1,2,2,0,0,5
3004,1,1,1,1,1,5
3005,1,1,1,1,1,5
3006,1,1,1,1,1,5
3007,0,2,0,0,3,5
3008,1,1,1,1,1,5
3009,1,1,1,1,1,5
3010,1,1,1,1,1,5
3011,1,1,1,1,1,5
3012,1,1,1,1,1,5
3013,1,1,1,1,1,5
3014,1,1,1,1,1,5
3015,1,1,1,1,1,5
3016,1,2,1,0,1,5
3017,1,1,1,1,1,5
3018,2,1,1,1,0,5
3019,1,1,1,1,1,5
3020,1,1,1,1,1,5
3021,1,1,1,1,1,5
3022,1,1,1,1,1,5
3023,1,1,1,1,1,5
3024,0,1,2,1,1,5
3025,1,1,1,1,1,5
3026,1,1,1,1,1,5
3027,1,1,1,1,1,5
3028,1,1,1,1,1,5
3029,1,1,1,1,1,5
3030,1,1,1,1,1,5
3031,1,1,1,1,1,5
3032,1,1,2,0,1,5
3033,1,1,1,1,1,5
3034,1,1,1,1,1,5
3035,1,1,1,1,1,5
3036,1,1,1,1,1,5
3037,1,1,1,1,1,5
3038,1,1,1,1,1,5
3039,1,1,1,1,1,5
3040,1,1,1,1,1,5
3041,1,1,1,1,1,5
3042,1,1,1,1,1,5
3043,1,1,1,1,1,5
3044,1,1,1,1,1,5
3045,1,1,1,1,1,5
3046,1,1,1,1,1,5
3047,0,2,1,0,2,5
3048,1,1,1,1,1,5
3049,1,1,1,1,1,5
3050,1,1,1,1,1,5
3051,1,1,1,1,1,5
3052,1,2,1,0,1,5
3053,1,1,1,0,2,5
3054,1,1,1,1,1,5
3055,0,2,2,1,0,5
3056,1,1,1,1,1,5
3057,1,1,1,1,1,5
3058,1,1,1,1,1,5
3059,1,1,1,1,1,5
3060,1,1,1,1,1,5
3061,1,1,1,1,1,5
3062,1,1,1,1,1,5
3063,1,1,1,1,1,5
3064,1,1,1,1,1,5
3065,1,1,1,1,1,5
3066,1,1,1,0,2,5
3067,1,1,1,1,1,5
3068,1,1,1,1,1,5
3069,1,1,1,1,1,5
3070,1,1,1,1,1,5
3071,1,1,1,1,1,5
3072,1,1,1,1,1,5
3073,1,1,1,1,1,5
3074,1,1,1,1,1,5
3075,1,1,1,1,1,5
3076,1,2,1,0,1,5
3077,1,1,1,1,1,5
3078,1,1,1,1,1,5
3079,1,1,1,1,1,5
3080,1,1,1,1,1,5
3081,1,1,1,1,1,5
3082,1,1,1,1,1,5
3083,1,1,1,1,1,5
3084,1,1,1,0,2,5
3085,1,1,1,1,1,5
3086,1,1,1,1,1,5
3087,1,1,1,1,1,5
3088,1,1,1,2,0,5
3089,1,1,1,1,1,5
3090,2,1,1,0,1,5
3091,1,1,1,1,1,5
3092,0,4,1,0,0,5
3093,1,1,1,1,1,5
3094,2,1,1,0,1,5
3095,1,1,1,1,1,5
3096,1,1,1,1,1,5
3097,1,1,1,0,2,5
3098,1,1,2,0,1,5
3099,1,1,1,1,1,5
3100,1,1,1,1,1,5
3101,1,1,1,1,1,5
3102,1,1,1,1,1,5
3103,1,1,1,1,1,5
3104,1,1,1,1,1,5
3105,1,1,1,1,1,5
3106,1,1,1,1,1,5
3107,1,1,1,1,1,5
3108,1,1,1,1,1,5
3109,1,1,1,1,1,5
3110,1,1,1,1,1,5
3111,1,1,1,1,1,5
3112,1,1,1,1,1,5
3113,1,1,1,1,1,5
3114,1,1,1,1,1,5
3115,1,1,1,1,1,5
3116,1,1,1,1,1,5
3117,1,1,1,0,2,5
3118,1,1,1,1,1,5
3119,1,1,1,1,1,5
3120,1,1,1,1,1,5
3121,1,1,1,1,1,5
3122,1,1,1,1,1,5
3123,1,1,1,1,1,5
3124,0,1,2,0,2,5
3125,1,1,1,1,1,5
3126,1,1,1,1,1,5
3127,1,1,1,1,1,5
3128,1,1,1,1,1,5
3129,1,1,1,1,1,5
3130,1,1,1,1,1,5
3131,1,1,1,1,1,5
3132,2,1,1,0,1,5
3133,1,1,1,1,1,5
3134,1,1,1,1,1,5
3135,1,1,1,1,1,5
3136,1,1,1,1,1,5
3137,1,1,1,1,1,5
3138,1,1,1,1,1,5
3139,1,1,1,1,1,5
3140,1,1,1,1,1,5
3141,1,1,1,1,1,5
3142,1,1,1,0,2,5
3143,1,2,1,0,1,5
3144,1,1,1,1,1,5
3145,1,1,1,1,1,5
3146,1,1,1,1,1,5
3147,1,1,1,1,1,5
3148,1,1,1,1,1,5
3149,1,1,1,1,1,5
3150,1,1,1,1,1,5
3151,1,1,1,1,1,5
3152,1,1,1,1,1,5
3153,1,1,1,0,2,5
3154,1,1,1,1,1,5
3155,1,1,1,1,1,5
3156,1,1,1,0,2,5
3157,1,1,1,1,1,5
3158,1,1,1,1,1,5
3159,1,1,1,1,1,5
3160,1,1,1,1,1,5
3161,1,1,1,1,1,5
3162,1,1,1,1,1,5
3163,1,1,1,1,1,5
3164,1,1,1,1,1,5
3165,1,1,1,1,1,5
3166,1,1,1,1,1,5
3167,1,1,1,1,1,5
3168,2,1,1,1,0,5
3169,1,1,1,1,1,5
3170,1,1,1,1,1,5
3171,1,1,1,1,1,5
3172,1,1,1,1,1,5
3173,1,1,1,1,1,5
3174,1,1,1,1,1,5
3175,1,1,1,1,1,5
3176,1,2,1,0,1,5
3177,1,1,1,1,1,5
3178,1,2,1,0,1,5
3179,1,1,0,2,1,5
3180,1,1,1,1,1,5
3181,1,1,1,1,1,5
3182,1,1,1,1,1,5
3183,1,1,1,1,1,5
3184,1,1,1,1,1,5
3185,1,1,1,1,1,5
3186,1,1,1,1,1,5
3187,1,1,1,1,1,5
3188,1,1,1,1,1,5
3189,1,1,1,1,1,5
3190,1,1,1,1,1,5
3191,1,1,1,1,1,5
3192,1,1,1,1,1,5
3193,1,1,1,1,1,5
3194,1,1,1,1,1,5
3195,1,1,1,1,1,5
3196,1,1,1,1,1,5
3197,1,1,0,2,1,5
3198,1,1,1,1,1,5
3199,1,1,1,1,1,5
3200,1,1,1,1,1,5
3201,1,1,1,1,1,5
3202,1,1,3,0,0,5
3203,1,1,1,1,1,5
3204,1,2,1,0,1,5
3205,1,1,1,1,1,5
3206,1,1,1,1,1,5
3207,1,1,1,1,1,5
3208,1,1,1,1,1,5
3209,1,1,1,1,1,5
3210,1,1,1,1,1,5
3211,1,1,1,1,1,5
3212,1,1,1,1,1,5
3213,1,1,0,1,2,5
3214,1,2,1,0,1,5
3215,1,2,1,0,1,5
3216,1,1,1,1,1,5
3217,1,1,1,1,1,5
3218,0,2,3,0,0,5
3219,1,1,1,1,1,5
3220,1,1,1,1,1,5
3221,1,1,1,1,1,5
3222,1,1,1,1,1,5
3223,1,1,1,1,1,5
3224,1,1,1,1,1,5
3225,1,1,1,1,1,5
3226,1,1,1,1,1,5
3227,1,1,1,1,1,5
3228,1,1,1,1,1,5
3229,1,1,1,1,1,5
3230,1,1,1,1,1,5
3231,1,1,1,1,1,5
3232,1,1,1,1,1,5
3233,2,1,1,0,1,5
3234,1,1,1,1,1,5
3235,1,1,1,1,1,5
3236,1,1,1,1,1,5
3237,1,1,1,1,1,5
3238,1,1,1,1,1,5
3239,1,2,1,0,1,5
3240,1,1,1,1,1,5
3241,1,1,1,1,1,5
3242,1,1,1,1,1,5
3243,0,2,1,0,2,5
3244,1,1,1,1,1,5
3245,1,1,1,1,1,5
3246,1,1,1,1,1,5
3247,1,1,1,1,1,5
3248,0,1,1,1,2,5
3249,1,1,1,1,1,5
3250,0,2,1,1,1,5
3251,1,1,1,0,2,5
3252,1,1,1,1,1,5
3253,1,1,1,1,1,5
3254,1,1,1,1,1,5
3255,1,1,1,1,1,5
3256,1,1,1,1,1,5
3257,1,1,1,1,1,5
3258,1,1,1,1,1,5
3259,1,1,1,1,1,5
3260,1,1,1,1,1,5
3261,1,1,1,1,1,5
3262,1,1,1,1,1,5
3263,1,1,1,1,1,5
3264,1,1,1,1,1,5
3265,1,1,1,1,1,5
3266,1,1,1,1,1,5
3267,1,1,1,1,1,5
3268,1,1,1,1,1,5
3269,1,1,1,1,1,5
3270,1,1,1,1,1,5
3271,1,1,1,1,1,5
3272,1,1,1,1,1,5
3273,1,1,1,2,0,5
3274,1,2,2,0,0,5
3275,1,1,1,1,1,5
3276,1,1,1,1,1,5
3277,1,1,1,1,1,5
3278,1,1,1,1,1,5
3279,1,1,1,1,1,5
3280,1,1,1,1,1,5
3281,1,1,1,1,1,5
3282,1,1,1,1,1,5
3283,1,1,1,1,1,5
3284,1,1,1,1,1,5
3285,1,1,1,1,1,5
3286,1,1,1,1,1,5
3287,1,1,1,1,1,5
3288,1,1,1,1,1,5
3289,1,1,1,1,1,5
3290,1,1,1,1,1,5
3291,1,2,1,0,1,5
3292,1,1,1,1,1,5
3293,1,1,1,1,1,5
3294,1,1,1,1,1,5
3295,1,1,1,1,1,5
3296,1,1,1,1,1,5
3297,1,1,1,1,1,5
3298,1,1,1,1,1,5
3299,1,1,1,1,1,5
3300,1,2,1,0,1,5
3301,1,2,1,0,1,5
3302,1,1,1,1,1,5
3303,1,1,1,1,1,5
3304,1,1,1,1,1,5
3305,1,2,1,0,1,5
3306,1,1,1,1,1,5
3307,1,1,1,1,1,5
3308,1,1,1,1,1,5
3309,1,1,1,1,1,5
3310,1,1,1,1,1,5
3311,1,1,1,1,1,5
3312,1,1,1,1,1,5
3313,1,1,1,1,1,5
3314,1,1,1,1,1,5
3315,1,1,1,1,1,5
3316,1,1,1,1,1,5
3317,1,1,1,1,1,5
3318,1,1,1,1,1,5
3319,1,1,1,1,1,5
3320,1,1,1,1,1,5
3321,1,1,1,1,1,5
3322,1,1,1,1,1,5
3323,1,1,1,1,1,5
3324,1,2,1,0,1,5
3325,1,1,1,1,1,5
3326,1,1,1,1,1,5
3327,1,1,1,1,1,5
3328,0,2,1,0,2,5
3329,1,1,1,1,1,5
3330,2,1,1,0,1,5
3331,1,1,1,1,1,5
3332,1,1,1,1,1,5
3333,1,1,1,1,1,5
3334,1,1,1,1,1,5
3335,1,1,1,1,1,5
3336,1,1,1,1,1,5
3337,1,1,1,1,1,5
3338,1,1,1,1,1,5
3339,1,1,1,1,1,5
3340,1,1,1,0,2,5
3341,1,1,1,1,1,5
3342,1,2,1,0,1,5
3343,1,1,1,1,1,5
3344,1,1,1,1,1,5
3345,1,1,1,1,1,5
3346,1,1,1,1,1,5
3347,1,1,1,1,1,5
3348,1,1,1,1,1,5
3349,1,1,1,1,1,5
3350,1,1,1,1,1,5
3351,1,1,1,1,1,5
3352,1,1,1,1,1,5
3353,1,1,1,1,1,5
3354,1,1,1,1,1,5
3355,1,1,1,1,1,5
3356,1,1,1,1,1,5
3357,1,1,1,1,1,5
3358,1,1,1,1,1,5
3359,1,1,1,1,1,5
3360,1,1,1,1,1,5
3361,1,1,1,1,1,5
3362,1,2,1,0,1,5
3363,1,1,1,1,1,5
3364,1,1,1,1,1,5
3365,1,1,1,1,1,5
3366,1,2,1,1,0,5
3367,1,1,1,1,1,5
3368,1,1,1,1,1,5
3369,1,1,1,1,1,5
3370,1,1,1,1,1,5
3371,1,1,1,1,1,5
3372,1,2,1,0,1,5
3373,1,1,1,1,1,5
3374,1,1,1,1,1,5
3375,1,1,1,1,1,5
3376,1,2,1,0,1,5
3377,1,1,1,1,1,5
3378,1,1,1,1,1,5
3379,1,1,1,1,1,5
3380,1,1,1,1,1,5
3381,1,1,1,1,1,5
3382,1,1,1,1,1,5
3383,1,1,1,1,1,5
3384,1,0,1,1,2,5
3385,1,1,1,1,1,5
3386,1,1,1,1,1,5
3387,1,1,1,1,1,5
3388,1,1,1,1,1,5
3389,1,1,1,1,1,5
3390,1,1,1,1,1,5
3391,1,1,1,1,1,5
3392,1,1,1,1,1,5
3393,1,1,1,1,1,5
3394,1,1,1,1,1,5
3395,1,1,1,1,1,5
3396,1,1,1,1,1,5
3397,1,1,0,2,1,5
3398,1,1,1,0,2,5
3399,1,1,1,1,1,5
3400,1,1,1,1,1,5
3401,1,1,1,1,1,5
3402,1,1,1,1,1,5
3403,1,1,1,1,1,5
3404,1,1,1,1,1,5
3405,1,1,1,1,1,5
3406,1,1,1,0,2,5
3407,0,2,1,1,1,5
3408,1,1,1,1,1,5
3409,1,1,1,1,1,5
3410,1,1,1,1,1,5
3411,1,1,1,1,1,5
3412,1,1,1,0,2,5
3413,1,1,1,1,1,5
3414,1,1,1,1,1,5
3415,1,1,1,1,1,5
3416,1,1,1,1,1,5
3417,1,1,1,1,1,5
3418,1,1,1,1,1,5
3419,1,1,1,1,1,5
3420,1,1,1,1,1,5
3421,1,1,1,1,1,5
3422,1,1,1,1,1,5
3423,0,1,3,0,1,5
3424,1,1,2,0,1,5
3425,1,1,2,0,1,5
3426,1,1,1,1,1,5
3427,1,1,1,1,1,5
3428,1,1,1,1,1,5
3429,0,0,4,1,0,5
3430,1,1,1,1,1,5
3431,0,0,1,0,4,5
3432,0,1,3,0,1,5
3433,2,1,1,0,1,5
3434,0,1,3,0,1,5
3435,0,2,1,0,2,5
3436,1,0,1,0,3,5
3437,1,1,1,1,1,5
3438,1,1,1,1,1,5
3439,0,1,4,0,0,5
3440,1,2,1,0,1,5
3441,1,1,1,1,1,5
3442,1,0,1,1,2,5
3443,1,1,1,1,1,5
3444,1,1,2,0,1,5
3445,0,0,1,0,4,5
3446,0,0,1,4,0,5
3447,0,0,0,4,1,5
3448,0,0,0,5,0,5
3449,1,0,0,4,0,5
3450,1,1,1,1,1,5
3451,0,0,0,4,1,5
3452,2,0,0,2,1,5
3453,1,0,0,3,1,5
3454,1,1,1,1,1,5
3455,0,0,0,5,0,5
3456,0,0,0,5,0,5
3457,0,0,0,5,0,5
3458,0,0,0,5,0,5
3459,1,2,1,0,1,5
3460,0,0,0,0,5,5
3461,0,2,2,0,1,5
3462,1,1,2,0,1,5
3463,0,2,1,0,2,5
3464,0,0,0,0,5,5
3465,0,2,1,0,2,5
3466,0,5,0,0,0,5
3467,0,2,3,0,0,5
3468,0,2,2,1,0,5
3469,0,3,0,0,2,5
3470,0,5,0,0,0,5
3471,0,2,2,0,1,5
3472,0,5,0,0,0,5
3473,0,3,1,0,1,5
3474,0,2,1,0,2,5
3475,0,3,1,0,1,5
3476,0,5,0,0,0,5
3477,0,5,0,0,0,5
3478,0,4,1,0,0,5
3479,0,2,1,1,1,5
3480,0,2,2,0,1,5
3481,0,2,2,0,1,5
3482,0,2,2,0,1,5
3483,0,1,4,0,0,5
3484,0,1,1,1,2,5
3485,0,2,3,0,0,5
3486,0,4,1,0,0,5
3487,0,4,1,0,0,5
3488,0,2,3,0,0,5
3489,0,2,2,0,1,5
3490,0,2,3,0,0,5
3491,0,2,3,0,0,5
3492,0,1,1,2,1,5
3493,0,2,3,0,0,5
3494,0,2,1,2,0,5
3495,0,2,2,0,1,5
3496,0,2,2,0,1,5
3497,0,2,2,0,1,5
3498,0,2,1,0,2,5
3499,0,1,1,1,2,5
3500,0,3,2,0,0,5
3501,0,1,2,0,2,5
3502,0,2,3,0,0,5
3503,0,2,3,0,0,5
3504,0,3,1,0,1,5
3505,0,1,3,0,1,5
3506,0,1,3,0,1,5
3507,0,1,4,0,0,5
3508,0,1,1,1,2,5
3509,0,1,1,0,3,5
3510,0,1,2,0,2,5
3511,0,1,2,0,2,5
3512,0,1,3,0,1,5
3513,0,1,1,2,1,5
3514,0,2,1,0,2,5
3515,0,2,1,0,2,5
3516,0,1,1,1,2,5
3517,0,1,1,0,3,5
3518,0,1,2,1,1,5
3519,0,2,1,0,2,5
3520,0,0,0,0,5,5
3521,0,0,2,3,0,5
3522,0,0,5,0,0,5
3523,0,0,4,0,1,5
3524,0,0,5,0,0,5
3525,0,0,1,0,4,5
3526,0,0,0,5,0,5
3527,0,0,0,5,0,5
3528,0,0,0,5,0,5
3529,0,0,0,5,0,5
3530,0,0,0,0,5,5
3531,0,0,0,0,5,5
3532,1,1,1,0,1,4
3533,1,1,1,0,1,4
3534,1,1,1,0,1,4
3535,1,1,1,0,1,4
3536,1,1,1,0,1,4
3537,1,1,1,0,1,4
3538,1,1,1,0,1,4
3539,1,1,1,0,1,4
3540,1,1,1,0,1,4
3541,2,0,0,2,0,4
3542,1,1,1,0,1,4
3543,1,1,1,0,1,4
3544,2,1,1,0,0,4
3545,1,1,1,0,1,4
3546,1,1,1,0,1,4
3547,4,0,0,0,0,4
3548,1,1,2,0,0,4
3549,1,1,1,1,0,4
3550,1,1,1,0,1,4
3551,4,0,0,0,0,4
3552,1,1,1,0,1,4
3553,1,1,1,0,1,4
3554,1,1,1,0,1,4
3555,1,1,1,0,1,4
3556,1,1,2,0,0,4
3557,4,0,0,0,0,4
3558,1,1,1,0,1,4
3559,1,1,1,1,0,4
3560,1,1,1,0,1,4
3561,1,1,1,0,1,4
3562,2,1,1,0,0,4
3563,1,1,1,1,0,4
3564,1,1,0,1,1,4
3565,1,1,1,1,0,4
3566,4,0,0,0,0,4
3567,1,1,0,2,0,4
3568,4,0,0,0,0,4
3569,1,1,1,0,1,4
3570,1,1,1,0,1,4
3571,1,1,1,1,0,4
3572,1,2,1,0,0,4
3573,1,1,1,1,0,4
3574,1,0,1,1,1,4
3575,1,1,1,1,0,4
3576,1,1,1,1,0,4
3577,1,1,0,1,1,4
3578,2,1,1,0,0,4
3579,1,1,1,0,1,4
3580,1,1,1,0,1,4
3581,1,1,1,0,1,4
3582,1,1,1,0,1,4
3583,1,1,1,0,1,4
3584,1,1,1,0,1,4
3585,4,0,0,0,0,4
3586,1,0,0,0,3,4
3587,4,0,0,0,0,4
3588,1,1,1,0,1,4
3589,1,1,1,0,1,4
3590,1,1,1,1,0,4
3591,1,1,1,0,1,4
3592,2,1,0,1,0,4
3593,1,1,1,0,1,4
3594,1,1,1,0,1,4
3595,1,1,1,0,1,4
3596,1,1,0,1,1,4
3597,2,0,0,2,0,4
3598,1,1,1,0,1,4
3599,4,0,0,0,0,4
3600,1,1,0,1,1,4
3601,1,1,1,0,1,4
3602,1,1,1,0,1,4
3603,1,1,1,0,1,4
3604,1,1,1,0,1,4
3605,1,1,1,0,1,4
3606,1,1,1,0,1,4
3607,1,1,1,0,1,4
3608,1,1,1,1,0,4
3609,3,0,0,1,0,4
3610,1,1,1,0,1,4
3611,1,1,1,0,1,4
3612,3,0,1,0,0,4
3613,2,1,1,0,0,4
3614,1,1,1,0,1,4
3615,1,1,1,0,1,4
3616,4,0,0,0,0,4
3617,1,1,1,0,1,4
3618,1,1,1,1,0,4
3619,1,1,1,0,1,4
3620,1,1,1,0,1,4
3621,1,0,1,1,1,4
3622,1,1,1,0,1,4
3623,1,1,1,1,0,4
3624,1,1,1,0,1,4
3625,1,1,1,1,0,4
3626,1,1,1,0,1,4
3627,1,1,1,1,0,4
3628,1,1,0,1,1,4
3629,1,1,1,0,1,4
3630,4,0,0,0,0,4
3631,1,1,1,1,0,4
3632,4,0,0,0,0,4
3633,1,1,1,0,1,4
3634,4,0,0,0,0,4
3635,1,1,1,0,1,4
3636,1,1,1,0,1,4
3637,2,0,2,0,0,4
3638,2,0,0,1,1,4
3639,1,1,1,0,1,4
3640,1,1,1,0,1,4
3641,1,1,1,0,1,4
3642,1,0,0,3,0,4
3643,2,1,1,0,0,4
3644,3,0,0,1,0,4
3645,1,0,1,2,0,4
3646,1,1,1,0,1,4
3647,1,1,1,0,1,4
3648,4,0,0,0,0,4
3649,1,1,1,0,1,4
3650,1,1,0,1,1,4
3651,1,1,1,0,1,4
3652,2,0,0,2,0,4
3653,1,1,1,1,0,4
3654,2,0,0,2,0,4
3655,1,1,1,0,1,4
3656,1,1,1,1,0,4
3657,1,1,1,0,1,4
3658,1,1,1,0,1,4
3659,1,1,1,0,1,4
3660,1,0,1,2,0,4
3661,1,1,1,0,1,4
3662,3,0,0,1,0,4
3663,1,1,1,1,0,4
3664,1,1,1,0,1,4
3665,1,1,1,0,1,4
3666,1,1,1,0,1,4
3667,1,1,1,0,1,4
3668,1,1,1,0,1,4
3669,2,1,1,0,0,4
3670,3,0,0,1,0,4
3671,2,0,1,1,0,4
3672,1,1,1,0,1,4
3673,1,1,1,1,0,4
3674,1,1,1,0,1,4
3675,1,1,1,0,1,4
3676,1,1,1,0,1,4
3677,1,1,1,0,1,4
3678,1,1,1,0,1,4
3679,1,0,0,1,2,4
3680,2,0,0,1,1,4
3681,1,1,1,0,1,4
3682,2,1,1,0,0,4
3683,2,0,0,2,0,4
3684,2,1,0,0,1,4
3685,1,1,1,0,1,4
3686,1,1,1,0,1,4
3687,1,1,1,0,1,4
3688,1,1,1,0,1,4
3689,1,1,0,1,1,4
3690,1,1,1,0,1,4
3691,1,1,1,0,1,4
3692,1,1,1,0,1,4
3693,1,1,1,1,0,4
3694,1,1,1,0,1,4
3695,1,1,1,0,1,4
3696,1,1,1,0,1,4
3697,1,1,1,0,1,4
3698,4,0,0,0,0,4
3699,4,0,0,0,0,4
3700,1,0,0,3,0,4
3701,1,1,1,0,1,4
3702,1,1,1,1,0,4
3703,1,1,1,0,1,4
3704,1,1,1,0,1,4
3705,2,1,1,0,0,4
3706,1,1,1,0,1,4
3707,1,1,1,0,1,4
3708,1,1,1,0,1,4
3709,2,0,1,0,1,4
3710,4,0,0,0,0,4
3711,1,1,1,0,1,4
3712,1,1,0,1,1,4
3713,1,1,1,0,1,4
3714,2,0,0,2,0,4
3715,1,1,1,0,1,4
3716,1,1,1,1,0,4
3717,1,1,1,0,1,4
3718,1,1,1,1,0,4
3719,1,1,1,0,1,4
3720,3,0,0,1,0,4
3721,3,0,0,1,0,4
3722,1,1,1,1,0,4
3723,1,1,1,1,0,4
3724,1,1,1,0,1,4
3725,1,1,1,0,1,4
3726,2,1,0,0,1,4
3727,1,1,1,0,1,4
3728,1,1,1,0,1,4
3729,2,0,0,0,2,4
3730,1,0,1,1,1,4
3731,1,1,1,0,1,4
3732,1,1,1,0,1,4
3733,1,1,1,0,1,4
3734,1,1,1,0,1,4
3735,1,0,0,3,0,4
3736,1,1,1,0,1,4
3737,3,0,0,0,1,4
3738,1,1,1,0,1,4
3739,1,1,2,0,0,4
3740,2,1,0,1,0,4
3741,1,1,1,0,1,4
3742,1,1,1,0,1,4
3743,1,1,1,0,1,4
3744,1,1,1,1,0,4
3745,1,1,1,1,0,4
3746,1,1,1,0,1,4
3747,1,1,1,0,1,4
3748,1,1,1,0,1,4
3749,1,1,1,0,1,4
3750,1,1,1,0,1,4
3751,2,0,1,0,1,4
3752,1,1,1,1,0,4
3753,1,1,1,0,1,4
3754,1,1,1,0,1,4
3755,4,0,0,0,0,4
3756,1,1,1,0,1,4
3757,1,1,1,0,1,4
3758,1,1,1,0,1,4
3759,1,1,1,0,1,4
3760,2,1,1,0,0,4
3761,1,1,1,0,1,4
3762,1,1,1,0,1,4
3763,1,1,1,0,1,4
3764,3,0,0,1,0,4
3765,1,1,2,0,0,4
3766,1,1,1,1,0,4
3767,1,1,1,0,1,4
3768,1,1,0,1,1,4
3769,1,1,1,1,0,4
3770,1,1,1,0,1,4
3771,1,1,1,0,1,4
3772,1,1,1,0,1,4
3773,1,1,1,1,0,4
3774,1,1,1,1,0,4
3775,1,1,1,1,0,4
3776,1,1,1,0,1,4
3777,1,1,1,0,1,4
3778,1,1,1,0,1,4
3779,1,0,0,2,1,4
3780,1,1,1,1,0,4
3781,1,1,1,0,1,4
3782,1,1,1,0,1,4
3783,1,1,1,0,1,4
3784,1,1,1,1,0,4
3785,1,1,1,0,1,4
3786,1,0,0,3,0,4
3787,3,0,1,0,0,4
3788,1,1,1,0,1,4
3789,1,1,1,0,1,4
3790,1,1,1,1,0,4
3791,1,1,1,0,1,4
3792,1,1,1,0,1,4
3793,1,1,0,1,1,4
3794,1,1,1,0,1,4
3795,1,1,1,0,1,4
3796,1,1,1,0,1,4
3797,3,0,0,0,1,4
3798,1,1,1,0,1,4
3799,1,1,1,0,1,4
3800,1,1,1,0,1,4
3801,1,1,1,0,1,4
3802,2,1,0,0,1,4
3803,1,1,1,0,1,4
3804,1,1,1,0,1,4
3805,1,1,1,0,1,4
3806,2,1,1,0,0,4
3807,1,1,1,0,1,4
3808,2,1,1,0,0,4
3809,1,1,1,0,1,4
3810,1,1,1,0,1,4
3811,1,1,1,1,0,4
3812,1,1,1,1,0,4
3813,1,1,1,0,1,4
3814,2,1,0,0,1,4
3815,1,1,1,1,0,4
3816,1,1,1,1,0,4
3817,1,1,1,0,1,4
3818,1,1,1,0,1,4
3819,1,1,1,1,0,4
3820,2,1,0,1,0,4
3821,4,0,0,0,0,4
3822,2,1,1,0,0,4
3823,1,1,1,0,1,4
3824,2,0,0,2,0,4
3825,1,1,1,0,1,4
3826,1,1,1,0,1,4
3827,1,1,1,0,1,4
3828,3,0,0,1,0,4
3829,1,1,1,0,1,4
3830,1,1,1,0,1,4
3831,4,0,0,0,0,4
3832,3,0,0,1,0,4
3833,1,1,1,0,1,4
3834,3,0,0,0,1,4
3835,4,0,0,0,0,4
3836,1,1,1,0,1,4
3837,1,1,1,1,0,4
3838,1,1,1,1,0,4
3839,1,1,1,0,1,4
3840,2,1,1,0,0,4
3841,1,1,1,0,1,4
3842,1,1,1,1,0,4
3843,1,1,1,0,1,4
3844,1,1,1,0,1,4
3845,4,0,0,0,0,4
3846,1,1,1,0,1,4
3847,2,1,1,0,0,4
3848,1,1,1,0,1,4
3849,1,1,1,0,1,4
3850,1,1,1,0,1,4
3851,1,1,1,1,0,4
3852,1,1,1,0,1,4
3853,1,1,1,0,1,4
3854,1,1,1,0,1,4
3855,1,1,1,1,0,4
3856,1,1,1,0,1,4
3857,1,1,1,0,1,4
3858,2,0,0,0,2,4
3859,1,1,1,0,1,4
3860,1,1,1,0,1,4
3861,1,1,1,0,1,4
3862,2,1,1,0,0,4
3863,2,1,1,0,0,4
3864,1,1,1,0,1,4
3865,1,1,1,0,1,4
3866,1,1,1,0,1,4
3867,1,1,1,0,1,4
3868,1,1,1,0,1,4
3869,1,1,1,0,1,4
3870,1,1,1,0,1,4
3871,1,1,1,0,1,4
3872,1,1,1,0,1,4
3873,1,1,1,0,1,4
3874,1,1,1,0,1,4
3875,2,0,0,2,0,4
3876,1,1,1,0,1,4
3877,1,1,1,0,1,4
3878,1,1,1,1,0,4
3879,1,1,1,0,1,4
3880,1,1,1,0,1,4
3881,1,1,1,0,1,4
3882,1,1,1,0,1,4
3883,1,1,1,0,1,4
3884,1,1,1,0,1,4
3885,1,1,1,0,1,4
3886,1,1,1,0,1,4
3887,1,1,1,0,1,4
3888,2,1,1,0,0,4
3889,1,1,1,0,1,4
3890,1,1,1,0,1,4
3891,1,1,1,0,1,4
3892,1,0,0,3,0,4
3893,3,0,0,0,1,4
3894,2,0,0,2,0,4
3895,1,1,1,0,1,4
3896,1,1,1,0,1,4
3897,1,1,1,0,1,4
3898,2,1,1,0,0,4
3899,1,1,1,0,1,4
3900,1,1,1,0,1,4
3901,1,1,1,0,1,4
3902,1,1,1,0,1,4
3903,1,1,1,1,0,4
3904,1,1,1,0,1,4
3905,1,1,1,0,1,4
3906,1,1,1,0,1,4
3907,2,0,0,1,1,4
3908,1,1,1,0,1,4
3909,1,0,1,1,1,4
3910,3,0,0,0,1,4
3911,1,1,1,0,1,4
3912,1,1,1,0,1,4
3913,1,1,1,0,1,4
3914,1,1,1,0,1,4
3915,1,1,1,1,0,4
3916,1,1,1,0,1,4
3917,2,0,0,2,0,4
3918,2,1,1,0,0,4
3919,1,1,1,0,1,4
3920,1,1,1,0,1,4
3921,1,1,1,0,1,4
3922,1,0,0,3,0,4
3923,1,1,1,0,1,4
3924,2,0,0,1,1,4
3925,1,1,1,0,1,4
3926,1,1,1,1,0,4
3927,1,1,1,0,1,4
3928,3,0,0,0,1,4
3929,2,1,1,0,0,4
3930,2,1,0,1,0,4
3931,1,1,1,0,1,4
3932,1,1,1,1,0,4
3933,1,1,1,0,1,4
3934,1,1,1,0,1,4
3935,1,1,1,0,1,4
3936,3,1,0,0,0,4
3937,2,1,1,0,0,4
3938,1,1,1,0,1,4
3939,1,1,1,0,1,4
3940,1,1,1,0,1,4
3941,1,1,1,0,1,4
3942,1,1,1,0,1,4
3943,1,1,1,0,1,4
3944,2,1,1,0,0,4
3945,2,1,1,0,0,4
3946,1,1,1,0,1,4
3947,2,1,1,0,0,4
3948,1,1,1,0,1,4
3949,1,1,1,0,1,4
3950,1,1,1,1,0,4
3951,1,1,1,0,1,4
3952,1,1,2,0,0,4
3953,2,1,0,0,1,4
3954,3,0,0,1,0,4
3955,1,1,1,0,1,4
3956,1,1,1,0,1,4
3957,1,1,1,0,1,4
3958,1,1,1,1,0,4
3959,0,2,0,0,2,4
3960,1,1,1,1,0,4
3961,1,1,1,0,1,4
3962,1,1,1,0,1,4
3963,1,1,1,0,1,4
3964,0,1,1,0,2,4
3965,1,1,1,1,0,4
3966,1,1,1,0,1,4
3967,1,1,1,0,1,4
3968,1,1,0,1,1,4
3969,1,1,1,0,1,4
3970,1,1,1,1,0,4
3971,1,1,0,1,1,4
3972,1,1,1,0,1,4
3973,1,1,1,0,1,4
3974,1,1,1,0,1,4
3975,1,1,1,1,0,4
3976,1,1,1,0,1,4
3977,1,1,0,1,1,4
3978,1,1,1,0,1,4
3979,1,1,1,0,1,4
3980,1,1,1,1,0,4
3981,1,1,1,0,1,4
3982,1,1,1,1,0,4
3983,2,1,1,0,0,4
3984,1,1,0,0,2,4
3985,1,1,1,0,1,4
3986,1,1,1,0,1,4
3987,0,1,1,1,1,4
3988,1,1,1,0,1,4
3989,0,1,1,0,2,4
3990,1,1,1,0,1,4
3991,0,2,2,0,0,4
3992,1,1,1,0,1,4
3993,1,1,1,0,1,4
3994,1,1,1,0,1,4
3995,1,1,1,0,1,4
3996,1,1,1,0,1,4
3997,1,1,1,0,1,4
3998,1,1,1,0,1,4
3999,1,1,1,0,1,4
4000,1,1,1,1,0,4
4001,1,1,0,1,1,4
4002,1,1,1,0,1,4
4003,1,1,1,0,1,4
4004,1,1,1,0,1,4
4005,1,1,1,1,0,4
4006,1,1,1,0,1,4
4007,1,1,1,0,1,4
4008,1,1,1,0,1,4
4009,1,1,1,0,1,4
4010,1,1,1,0,1,4
4011,1,1,1,0,1,4
4012,0,2,1,0,1,4
4013,1,1,1,0,1,4
4014,1,1,1,0,1,4
4015,1,1,1,0,1,4
4016,1,1,1,0,1,4
4017,1,1,1,0,1,4
4018,1,1,1,1,0,4
4019,1,1,1,0,1,4
4020,0,1,2,0,1,4
4021,1,1,1,0,1,4
4022,0,1,1,1,1,4
4023,1,1,1,1,0,4
4024,1,1,1,1,0,4
4025,1,1,1,0,1,4
4026,1,1,1,1,0,4
4027,1,1,1,0,1,4
4028,1,1,1,0,1,4
4029,1,1,1,0,1,4
4030,1,1,1,0,1,4
4031,1,1,1,0,1,4
4032,1,1,1,0,1,4
4033,1,1,1,0,1,4
4034,1,1,1,0,1,4
4035,0,2,1,1,0,4
4036,1,1,1,0,1,4
4037,1,2,1,0,0,4
4038,1,1,1,0,1,4
4039,1,1,1,0,1,4
4040,1,1,1,0,1,4
4041,0,1,1,1,1,4
4042,1,1,1,1,0,4
4043,1,1,0,1,1,4
4044,0,2,1,0,1,4
4045,0,3,1,0,0,4
4046,0,3,1,0,0,4
4047,1,1,1,0,1,4
4048,1,1,1,0,1,4
4049,1,1,1,0,1,4
4050,1,1,0,1,1,4
4051,1,2,1,0,0,4
4052,1,1,1,1,0,4
4053,1,1,1,0,1,4
4054,1,1,1,0,1,4
4055,0,1,2,0,1,4
4056,1,1,0,1,1,4
4057,0,2,1,0,1,4
4058,1,1,0,1,1,4
4059,1,1,0,1,1,4
4060,0,1,1,1,1,4
4061,1,1,1,1,0,4
4062,1,1,1,0,1,4
4063,1,1,1,0,1,4
4064,1,1,1,0,1,4
4065,1,1,1,0,1,4
4066,1,1,1,0,1,4
4067,1,1,1,0,1,4
4068,1,1,1,0,1,4
4069,1,1,1,0,1,4
4070,1,1,1,0,1,4
4071,1,1,1,0,1,4
4072,1,1,0,1,1,4
4073,1,1,1,1,0,4
4074,1,1,1,0,1,4
4075,1,1,0,1,1,4
4076,1,1,1,0,1,4
4077,1,1,1,0,1,4
4078,1,1,1,0,1,4
4079,1,1,0,1,1,4
4080,1,1,1,0,1,4
4081,1,1,1,1,0,4
4082,1,1,1,0,1,4
4083,1,1,1,0,1,4
4084,1,1,1,0,1,4
4085,1,1,1,0,1,4
4086,1,1,1,0,1,4
4087,1,1,1,0,1,4
4088,1,1,1,0,1,4
4089,0,1,1,0,2,4
4090,1,1,1,0,1,4
4091,1,1,0,1,1,4
4092,1,1,1,0,1,4
4093,1,1,1,0,1,4
4094,1,1,1,0,1,4
4095,1,1,1,0,1,4
4096,1,1,1,1,0,4
4097,1,1,1,0,1,4
4098,1,1,1,0,1,4
4099,1,1,1,0,1,4
4100,1,1,1,0,1,4
4101,1,1,1,0,1,4
4102,1,1,1,0,1,4
4103,1,1,1,0,1,4
4104,1,1,1,0,1,4
4105,1,1,1,0,1,4
4106,1,1,1,0,1,4
4107,0,1,1,1,1,4
4108,1,1,1,1,0,4
4109,0,1,1,0,2,4
4110,1,1,1,1,0,4
4111,1,1,1,0,1,4
4112,1,1,1,1,0,4
4113,1,1,1,0,1,4
4114,1,1,1,0,1,4
4115,0,1,1,1,1,4
4116,1,1,1,0,1,4
4117,1,1,1,1,0,4
4118,1,1,1,1,0,4
4119,1,1,1,0,1,4
4120,1,1,1,0,1,4
4121,1,1,1,0,1,4
4122,1,1,1,0,1,4
4123,1,1,1,0,1,4
4124,1,1,1,0,1,4
4125,1,1,1,0,1,4
4126,1,1,1,0,1,4
4127,1,1,1,0,1,4
4128,1,1,1,0,1,4
4129,1,1,1,0,1,4
4130,1,1,1,0,1,4
4131,1,1,1,0,1,4
4132,1,0,0,3,0,4
4133,1,1,1,0,1,4
4134,0,2,1,0,1,4
4135,1,1,1,0,1,4
4136,1,1,1,0,1,4
4137,1,1,1,0,1,4
4138,1,1,1,0,1,4
4139,1,1,1,0,1,4
4140,1,1,1,0,1,4
4141,1,1,1,0,1,4
4142,1,1,1,0,1,4
4143,1,1,1,0,1,4
4144,0,2,2,0,0,4
4145,1,1,1,0,1,4
4146,1,1,1,0,1,4
4147,0,2,1,0,1,4
4148,1,2,1,0,0,4
4149,1,1,1,0,1,4
4150,0,1,1,1,1,4
4151,1,1,1,1,0,4
4152,1,1,1,1,0,4
4153,1,1,1,0,1,4
4154,1,1,1,0,1,4
4155,1,1,1,0,1,4
4156,1,1,1,0,1,4
4157,1,1,1,0,1,4
4158,0,1,2,0,1,4
4159,1,0,3,0,0,4
4160,1,1,1,0,1,4
4161,1,0,1,1,1,4
4162,1,1,1,0,1,4
4163,1,1,1,0,1,4
4164,1,1,1,0,1,4
4165,1,1,1,0,1,4
4166,0,1,1,1,1,4
4167,1,1,1,0,1,4
4168,1,1,1,1,0,4
4169,1,1,1,0,1,4
4170,1,1,1,0,1,4
4171,1,1,1,0,1,4
4172,1,1,1,0,1,4
4173,1,1,1,0,1,4
4174,1,1,1,0,1,4
4175,2,1,1,0,0,4
4176,1,0,1,1,1,4
4177,1,1,1,0,1,4
4178,1,1,1,0,1,4
4179,1,1,0,1,1,4
4180,1,1,0,1,1,4
4181,1,1,1,0,1,4
4182,1,1,1,0,1,4
4183,1,2,1,0,0,4
4184,1,1,1,0,1,4
4185,1,1,1,0,1,4
4186,1,1,1,0,1,4
4187,1,1,1,0,1,4
4188,1,1,1,0,1,4
4189,1,1,0,1,1,4
4190,1,1,1,0,1,4
4191,1,1,1,0,1,4
4192,1,1,1,0,1,4
4193,1,1,1,0,1,4
4194,1,2,1,0,0,4
4195,1,1,1,0,1,4
4196,1,1,1,0,1,4
4197,1,1,1,0,1,4
4198,1,1,1,0,1,4
4199,1,1,1,1,0,4
4200,1,1,1,1,0,4
4201,0,1,1,1,1,4
4202,1,1,1,0,1,4
4203,1,1,1,0,1,4
4204,1,1,1,0,1,4
4205,0,2,1,0,1,4
4206,1,1,1,0,1,4
4207,0,2,1,0,1,4
4208,1,1,1,1,0,4
4209,1,1,1,0,1,4
4210,1,1,1,0,1,4
4211,0,1,1,1,1,4
4212,1,1,1,0,1,4
4213,1,1,1,0,1,4
4214,1,1,1,0,1,4
4215,1,1,1,0,1,4
4216,1,1,1,1,0,4
4217,1,1,1,0,1,4
4218,0,1,2,0,1,4
4219,1,1,1,0,1,4
4220,1,1,1,0,1,4
4221,1,1,1,0,1,4
4222,1,1,1,0,1,4
4223,1,1,1,0,1,4
4224,1,1,1,0,1,4
4225,0,1,1,0,2,4
4226,0,1,2,0,1,4
4227,1,1,1,0,1,4
4228,0,1,2,1,0,4
4229,1,1,1,0,1,4
4230,1,1,1,0,1,4
4231,1,1,1,0,1,4
4232,0,1,1,1,1,4
4233,1,1,1,0,1,4
4234,1,1,1,0,1,4
4235,1,1,1,0,1,4
4236,1,1,1,0,1,4
4237,1,1,1,0,1,4
4238,0,1,1,2,0,4
4239,1,1,1,0,1,4
4240,1,1,1,0,1,4
4241,1,1,1,0,1,4
4242,1,2,1,0,0,4
4243,1,1,1,0,1,4
4244,1,1,1,0,1,4
4245,1,1,1,0,1,4
4246,1,1,1,0,1,4
4247,1,1,1,1,0,4
4248,1,1,0,1,1,4
4249,1,1,1,0,1,4
4250,1,1,1,0,1,4
4251,1,1,1,0,1,4
4252,1,1,1,0,1,4
4253,0,1,1,1,1,4
4254,1,1,1,0,1,4
4255,1,1,1,1,0,4
4256,1,1,1,0,1,4
4257,1,1,1,0,1,4
4258,1,1,1,0,1,4
4259,0,1,1,1,1,4
4260,1,1,1,0,1,4
4261,1,1,1,0,1,4
4262,1,1,1,0,1,4
4263,1,1,1,0,1,4
4264,1,1,1,1,0,4
4265,1,1,1,0,1,4
4266,1,1,1,0,1,4
4267,1,1,1,0,1,4
4268,0,2,1,0,1,4
4269,1,1,1,0,1,4
4270,1,1,1,0,1,4
4271,1,1,1,1,0,4
4272,1,1,1,1,0,4
4273,1,1,1,1,0,4
4274,1,1,1,0,1,4
4275,1,1,1,1,0,4
4276,0,1,1,1,1,4
4277,1,1,1,0,1,4
4278,1,1,1,0,1,4
4279,1,1,1,0,1,4
4280,1,1,1,0,1,4
4281,1,1,1,1,0,4
4282,1,1,1,0,1,4
4283,1,1,1,1,0,4
4284,1,1,1,0,1,4
4285,1,1,1,0,1,4
4286,1,1,1,0,1,4
4287,1,1,1,1,0,4
4288,1,1,1,0,1,4
4289,1,1,1,1,0,4
4290,1,1,1,0,1,4
4291,1,1,1,0,1,4
4292,1,1,1,0,1,4
4293,1,1,1,0,1,4
4294,1,1,1,0,1,4
4295,1,1,1,0,1,4
4296,1,1,1,0,1,4
4297,1,1,1,1,0,4
4298,1,1,1,0,1,4
4299,0,2,1,0,1,4
4300,1,1,1,0,1,4
4301,1,1,1,0,1,4
4302,1,1,1,0,1,4
4303,1,1,1,1,0,4
4304,1,1,1,0,1,4
4305,1,1,1,0,1,4
4306,1,1,1,1,0,4
4307,1,1,1,0,1,4
4308,1,1,1,0,1,4
4309,0,1,1,1,1,4
4310,1,1,1,0,1,4
4311,1,1,1,1,0,4
4312,1,1,1,0,1,4
4313,1,1,1,0,1,4
4314,1,1,1,0,1,4
4315,1,1,1,0,1,4
4316,1,1,1,0,1,4
4317,1,1,1,0,1,4
4318,1,1,1,1,0,4
4319,1,2,1,0,0,4
4320,1,1,1,0,1,4
4321,1,1,1,0,1,4
4322,0,2,1,0,1,4
4323,1,1,1,1,0,4
4324,1,1,1,0,1,4
4325,1,1,1,0,1,4
4326,1,1,1,0,1,4
4327,1,2,1,0,0,4
4328,1,1,1,0,1,4
4329,0,1,1,1,1,4
4330,1,1,1,1,0,4
4331,1,1,1,0,1,4
4332,1,1,1,0,1,4
4333,0,2,1,0,1,4
4334,1,1,1,1,0,4
4335,1,1,1,0,1,4
4336,1,1,1,1,0,4
4337,1,1,1,0,1,4
4338,1,1,1,1,0,4
4339,1,1,1,0,1,4
4340,1,1,1,0,1,4
4341,1,1,1,0,1,4
4342,1,1,1,0,1,4
4343,1,1,1,0,1,4
4344,1,0,1,1,1,4
4345,1,1,1,0,1,4
4346,1,1,1,0,1,4
4347,1,1,1,0,1,4
4348,1,1,1,0,1,4
4349,1,1,1,0,1,4
4350,1,1,1,1,0,4
4351,1,1,1,0,1,4
4352,1,1,1,0,1,4
4353,0,1,1,1,1,4
4354,0,1,1,1,1,4
4355,1,1,1,1,0,4
4356,1,1,1,1,0,4
4357,1,1,1,0,1,4
4358,1,1,1,1,0,4
4359,1,1,1,0,1,4
4360,1,1,1,0,1,4
4361,1,1,1,1,0,4
4362,1,1,1,0,1,4
4363,1,1,1,0,1,4
4364,1,1,1,0,1,4
4365,1,1,1,0,1,4
4366,1,1,1,0,1,4
4367,1,1,1,0,1,4
4368,0,1,2,0,1,4
4369,0,2,1,0,1,4
4370,1,1,1,0,1,4
4371,0,2,1,0,1,4
4372,0,2,2,0,0,4
4373,1,1,1,0,1,4
4374,1,1,1,0,1,4
4375,1,1,1,0,1,4
4376,0,1,2,0,1,4
4377,1,1,1,0,1,4
4378,1,1,1,0,1,4
4379,1,0,0,3,0,4
4380,0,1,1,1,1,4
4381,0,1,1,1,1,4
4382,1,1,1,0,1,4
4383,1,1,1,1,0,4
4384,1,1,1,0,1,4
4385,1,1,1,0,1,4
4386,1,1,1,0,1,4
4387,1,1,1,0,1,4
4388,1,1,1,1,0,4
4389,1,1,1,0,1,4
4390,1,1,1,0,1,4
4391,1,1,1,1,0,4
4392,1,1,1,0,1,4
4393,1,1,1,0,1,4
4394,1,1,1,0,1,4
4395,1,1,1,0,1,4
4396,1,1,1,0,1,4
4397,1,1,0,1,1,4
4398,1,1,1,0,1,4
4399,1,1,1,0,1,4
4400,1,1,1,0,1,4
4401,1,1,1,0,1,4
4402,1,1,1,0,1,4
4403,1,1,1,0,1,4
4404,1,1,1,0,1,4
4405,1,1,0,1,1,4
4406,1,1,0,1,1,4
4407,1,1,1,0,1,4
4408,1,1,1,0,1,4
4409,1,1,1,0,1,4
4410,1,1,0,2,0,4
4411,1,1,1,0,1,4
4412,1,1,1,1,0,4
4413,1,1,1,0,1,4
4414,1,1,1,1,0,4
4415,1,1,1,1,0,4
4416,1,1,1,1,0,4
4417,0,1,1,1,1,4
4418,1,1,1,0,1,4
4419,1,1,1,0,1,4
4420,1,1,1,0,1,4
4421,1,1,0,1,1,4
4422,0,2,1,0,1,4
4423,0,1,1,1,1,4
4424,0,1,0,1,2,4
4425,1,1,1,0,1,4
4426,1,1,0,1,1,4
4427,1,1,1,0,1,4
4428,1,1,1,0,1,4
4429,1,1,1,0,1,4
4430,0,2,2,0,0,4
4431,1,1,1,0,1,4
4432,1,1,1,0,1,4
4433,1,1,1,0,1,4
4434,1,1,1,1,0,4
4435,1,1,1,0,1,4
4436,1,1,0,1,1,4
4437,1,1,1,0,1,4
4438,1,1,0,1,1,4
4439,1,1,0,1,1,4
4440,1,1,1,1,0,4
4441,0,1,1,1,1,4
4442,1,1,1,0,1,4
4443,0,1,3,0,0,4
4444,1,1,1,0,1,4
4445,1,1,1,0,1,4
4446,1,1,0,1,1,4
4447,1,1,1,0,1,4
4448,1,1,1,0,1,4
4449,1,1,1,0,1,4
4450,1,1,1,1,0,4
4451,1,1,0,2,0,4
4452,1,1,1,0,1,4
4453,1,1,1,1,0,4
4454,1,1,1,0,1,4
4455,1,1,1,0,1,4
4456,1,1,1,1,0,4
4457,1,1,1,0,1,4
4458,1,1,1,0,1,4
4459,1,1,1,1,0,4
4460,1,1,1,0,1,4
4461,1,1,1,1,0,4
4462,1,1,1,0,1,4
4463,0,1,1,0,2,4
4464,2,1,1,0,0,4
4465,1,1,0,1,1,4
4466,1,1,1,0,1,4
4467,1,1,1,0,1,4
4468,1,1,1,0,1,4
4469,1,1,1,0,1,4
4470,1,1,0,1,1,4
4471,1,1,1,0,1,4
4472,0,1,2,0,1,4
4473,1,1,1,0,1,4
4474,1,1,1,0,1,4
4475,1,1,1,1,0,4
4476,1,1,1,0,1,4
4477,1,1,1,0,1,4
4478,1,1,1,0,1,4
4479,1,1,1,0,1,4
4480,1,1,0,1,1,4
4481,1,1,1,0,1,4
4482,1,1,1,0,1,4
4483,1,1,0,1,1,4
4484,1,1,1,0,1,4
4485,1,1,1,0,1,4
4486,1,1,1,0,1,4
4487,1,1,1,0,1,4
4488,1,1,1,1,0,4
4489,1,1,1,0,1,4
4490,1,1,1,0,1,4
4491,0,1,1,1,1,4
4492,1,1,1,0,1,4
4493,1,1,0,1,1,4
4494,1,1,1,0,1,4
4495,1,1,1,0,1,4
4496,1,1,1,0,1,4
4497,1,1,1,0,1,4
4498,1,1,1,0,1,4
4499,1,1,1,0,1,4
4500,1,1,1,0,1,4
4501,1,1,1,1,0,4
4502,0,1,1,1,1,4
4503,1,1,1,0,1,4
4504,1,2,1,0,0,4
4505,1,1,1,1,0,4
4506,1,1,1,1,0,4
4507,1,1,1,0,1,4
4508,1,1,1,0,1,4
4509,1,1,1,0,1,4
4510,1,1,1,0,1,4
4511,2,1,1,0,0,4
4512,1,1,1,0,1,4
4513,1,1,1,0,1,4
4514,1,1,1,1,0,4
4515,1,1,1,0,1,4
4516,1,1,1,0,1,4
4517,1,1,1,0,1,4
4518,1,1,1,0,1,4
4519,1,1,1,0,1,4
4520,1,1,1,0,1,4
4521,1,1,1,0,1,4
4522,1,1,1,0,1,4
4523,1,1,1,0,1,4
4524,1,1,1,1,0,4
4525,1,1,1,0,1,4
4526,1,1,1,0,1,4
4527,1,1,1,0,1,4
4528,1,1,1,0,1,4
4529,0,1,1,0,2,4
4530,1,1,1,0,1,4
4531,1,1,1,0,1,4
4532,1,1,1,1,0,4
4533,1,1,1,1,0,4
4534,1,1,1,0,1,4
4535,1,1,1,0,1,4
4536,1,1,1,1,0,4
4537,1,1,1,1,0,4
4538,1,1,1,0,1,4
4539,1,1,1,1,0,4
4540,1,1,1,0,1,4
4541,1,1,1,0,1,4
4542,1,1,0,1,1,4
4543,1,1,0,1,1,4
4544,1,1,1,0,1,4
4545,1,1,1,1,0,4
4546,1,0,0,2,1,4
4547,0,1,1,0,2,4
4548,1,1,1,0,1,4
4549,1,1,0,1,1,4
4550,1,1,1,1,0,4
4551,2,1,1,0,0,4
4552,1,1,1,0,1,4
4553,1,1,1,1,0,4
4554,1,1,1,1,0,4
4555,1,1,1,0,1,4
4556,1,1,1,0,1,4
4557,1,1,1,0,1,4
4558,1,1,1,1,0,4
4559,1,1,0,1,1,4
4560,1,1,1,1,0,4
4561,1,1,1,0,1,4
4562,1,1,1,0,1,4
4563,1,1,1,0,1,4
4564,1,1,1,0,1,4
4565,1,1,1,0,1,4
4566,1,1,1,1,0,4
4567,1,1,1,1,0,4
4568,1,1,1,0,1,4
4569,0,1,1,1,1,4
4570,1,1,1,0,1,4
4571,1,1,1,1,0,4
4572,1,2,1,0,0,4
4573,1,1,1,0,1,4
4574,1,1,1,0,1,4
4575,1,1,1,0,1,4
4576,1,1,1,1,0,4
4577,1,1,1,0,1,4
4578,1,1,1,0,1,4
4579,0,1,1,1,1,4
4580,1,1,1,0,1,4
4581,1,1,1,0,1,4
4582,1,1,1,1,0,4
4583,1,1,1,0,1,4
4584,1,1,1,0,1,4
4585,1,1,1,0,1,4
4586,1,1,1,0,1,4
4587,1,1,1,1,0,4
4588,1,1,1,0,1,4
4589,1,1,1,0,1,4
4590,1,1,1,0,1,4
4591,1,1,1,0,1,4
4592,1,2,1,0,0,4
4593,1,1,1,1,0,4
4594,1,1,1,0,1,4
4595,0,2,1,0,1,4
4596,1,1,1,0,1,4
4597,1,1,1,1,0,4
4598,1,1,1,0,1,4
4599,0,2,1,0,1,4
4600,1,1,1,0,1,4
4601,1,1,1,1,0,4
4602,1,1,1,0,1,4
4603,0,1,1,1,1,4
4604,1,1,1,0,1,4
4605,1,1,1,0,1,4
4606,1,1,1,0,1,4
4607,1,1,1,1,0,4
4608,1,1,1,0,1,4
4609,1,1,1,0,1,4
4610,1,1,1,0,1,4
4611,1,1,1,1,0,4
4612,1,1,1,0,1,4
4613,1,1,0,1,1,4
4614,1,1,1,0,1,4
4615,1,1,1,1,0,4
4616,1,1,1,1,0,4
4617,1,1,1,0,1,4
4618,0,2,2,0,0,4
4619,1,1,1,0,1,4
4620,1,1,1,0,1,4
4621,1,1,1,0,1,4
4622,1,1,1,0,1,4
4623,1,1,1,0,1,4
4624,1,1,1,0,1,4
4625,1,1,1,0,1,4
4626,1,1,1,1,0,4
4627,1,1,1,0,1,4
4628,1,1,1,0,1,4
4629,1,1,1,0,1,4
4630,1,2,0,0,1,4
4631,1,1,1,0,1,4
4632,1,1,1,0,1,4
4633,1,0,1,1,1,4
4634,1,1,1,0,1,4
4635,0,1,1,0,2,4
4636,1,1,1,1,0,4
4637,1,1,1,0,1,4
4638,1,1,1,0,1,4
4639,1,1,1,0,1,4
4640,0,1,1,1,1,4
4641,1,1,1,0,1,4
4642,1,1,1,0,1,4
4643,1,1,1,0,1,4
4644,2,1,1,0,0,4
4645,1,1,1,0,1,4
4646,1,1,1,1,0,4
4647,1,1,1,0,1,4
4648,1,1,1,1,0,4
4649,1,1,1,0,1,4
4650,1,1,1,0,1,4
4651,1,1,1,0,1,4
4652,0,1,1,0,2,4
4653,1,1,1,0,1,4
4654,0,1,1,1,1,4
4655,0,2,2,0,0,4
4656,0,1,1,0,2,4
4657,1,1,1,0,1,4
4658,0,1,1,0,2,4
4659,1,1,1,1,0,4
4660,0,1,1,1,1,4
4661,1,1,1,0,1,4
4662,1,1,1,1,0,4
4663,1,1,1,0,1,4
4664,1,1,1,1,0,4
4665,1,1,0,1,1,4
4666,1,1,1,0,1,4
4667,0,1,2,0,1,4
4668,1,1,0,1,1,4
4669,1,1,1,1,0,4
4670,1,1,0,1,1,4
4671,1,1,1,0,1,4
4672,1,1,1,0,1,4
4673,1,2,1,0,0,4
4674,0,2,1,0,1,4
4675,1,1,1,0,1,4
4676,1,1,1,0,1,4
4677,1,1,1,0,1,4
4678,1,2,1,0,0,4
4679,1,1,1,0,1,4
4680,1,1,1,0,1,4
4681,1,1,1,0,1,4
4682,0,1,1,1,1,4
4683,0,2,1,0,1,4
4684,1,1,1,0,1,4
4685,1,1,1,0,1,4
4686,1,1,1,0,1,4
4687,1,1,1,0,1,4
4688,1,1,1,0,1,4
4689,1,2,1,0,0,4
4690,1,1,1,1,0,4
4691,1,1,1,0,1,4
4692,0,1,1,2,0,4
4693,1,1,0,1,1,4
4694,1,1,1,0,1,4
4695,1,1,1,0,1,4
4696,1,1,1,0,1,4
4697,1,1,1,0,1,4
4698,1,1,1,1,0,4
4699,0,1,1,1,1,4
4700,0,4,0,0,0,4
4701,1,1,1,0,1,4
4702,1,1,1,1,0,4
4703,1,1,1,0,1,4
4704,1,1,1,0,1,4
4705,1,1,1,0,1,4
4706,1,1,1,0,1,4
4707,1,1,0,1,1,4
4708,1,1,1,1,0,4
4709,1,1,1,1,0,4
4710,1,1,1,0,1,4
4711,1,1,1,0,1,4
4712,1,1,1,0,1,4
4713,1,1,1,0,1,4
4714,1,1,1,0,1,4
4715,1,1,1,0,1,4
4716,1,1,0,1,1,4
4717,1,1,1,0,1,4
4718,1,1,1,0,1,4
4719,0,1,1,1,1,4
4720,1,1,1,0,1,4
4721,1,1,1,0,1,4
4722,1,1,1,0,1,4
4723,1,1,1,0,1,4
4724,1,1,1,0,1,4
4725,1,1,1,0,1,4
4726,1,1,1,0,1,4
4727,1,1,1,1,0,4
4728,1,1,1,1,0,4
4729,1,1,0,1,1,4
4730,1,1,1,1,0,4
4731,1,1,1,0,1,4
4732,1,1,1,0,1,4
4733,0,1,1,1,1,4
4734,1,1,1,0,1,4
4735,0,1,1,0,2,4
4736,1,1,0,1,1,4
4737,1,1,1,0,1,4
4738,1,1,1,1,0,4
4739,1,1,1,0,1,4
4740,2,1,1,0,0,4
4741,1,1,0,1,1,4
4742,1,1,1,1,0,4
4743,0,1,1,0,2,4
4744,1,1,1,1,0,4
4745,1,1,1,1,0,4
4746,1,1,1,1,0,4
4747,1,1,0,1,1,4
4748,1,1,1,0,1,4
4749,1,1,0,1,1,4
4750,1,1,1,0,1,4
4751,1,1,1,1,0,4
4752,0,1,1,1,1,4
4753,1,1,1,0,1,4
4754,1,1,1,1,0,4
4755,0,2,0,0,2,4
4756,1,1,1,0,1,4
4757,1,1,1,0,1,4
4758,1,1,1,0,1,4
4759,1,1,1,1,0,4
4760,1,1,1,0,1,4
4761,1,1,1,0,1,4
4762,1,1,1,0,1,4
4763,1,1,1,0,1,4
4764,1,1,1,0,1,4
4765,1,1,1,0,1,4
4766,1,1,1,0,1,4
4767,1,1,1,1,0,4
4768,1,1,1,0,1,4
4769,1,1,1,0,1,4
4770,1,1,1,0,1,4
4771,0,1,1,1,1,4
4772,1,1,1,0,1,4
4773,1,1,1,0,1,4
4774,1,1,1,0,1,4
4775,1,1,1,1,0,4
4776,1,1,1,0,1,4
4777,1,1,1,0,1,4
4778,1,1,1,0,1,4
4779,1,1,1,1,0,4
4780,1,2,1,0,0,4
4781,0,2,1,0,1,4
4782,1,1,1,1,0,4
4783,1,1,1,0,1,4
4784,1,1,1,1,0,4
4785,1,1,1,0,1,4
4786,1,1,0,1,1,4
4787,1,1,1,0,1,4
4788,1,1,1,0,1,4
4789,1,1,1,0,1,4
4790,0,2,1,0,1,4
4791,1,1,1,0,1,4
4792,1,1,1,1,0,4
4793,1,1,1,1,0,4
4794,1,1,1,1,0,4
4795,1,1,1,1,0,4
4796,0,1,1,1,1,4
4797,1,1,1,0,1,4
4798,1,1,1,1,0,4
4799,1,1,1,0,1,4
4800,1,1,1,0,1,4
4801,1,1,1,0,1,4
4802,1,1,1,0,1,4
4803,1,1,1,0,1,4
4804,0,2,2,0,0,4
4805,1,1,1,0,1,4
4806,1,1,1,0,1,4
4807,1,1,1,0,1,4
4808,1,1,1,0,1,4
4809,1,1,1,0,1,4
4810,1,1,1,0,1,4
4811,1,1,1,0,1,4
4812,1,1,1,0,1,4
4813,1,1,0,1,1,4
4814,1,1,1,0,1,4
4815,1,1,1,0,1,4
4816,0,2,1,0,1,4
4817,1,1,1,0,1,4
4818,0,1,1,0,2,4
4819,1,1,1,0,1,4
4820,0,2,2,0,0,4
4821,1,1,1,0,1,4
4822,1,1,0,1,1,4
4823,1,1,1,0,1,4
4824,1,1,1,1,0,4
4825,1,1,1,0,1,4
4826,1,1,1,0,1,4
4827,1,1,1,0,1,4
4828,1,1,1,0,1,4
4829,1,1,0,1,1,4
4830,1,1,1,0,1,4
4831,0,1,1,1,1,4
4832,1,1,1,0,1,4
4833,1,1,1,0,1,4
4834,1,1,1,0,1,4
4835,1,1,1,0,1,4
4836,1,1,1,0,1,4
4837,1,1,1,1,0,4
4838,1,1,1,1,0,4
4839,1,1,1,0,1,4
4840,0,4,0,0,0,4
4841,1,1,1,0,1,4
4842,1,1,1,0,1,4
4843,0,0,4,0,0,4
4844,1,1,1,0,1,4
4845,0,1,1,1,1,4
4846,1,0,1,1,1,4
4847,1,1,1,0,1,4
4848,0,1,1,1,1,4
4849,0,0,1,2,1,4
4850,1,1,1,0,1,4
4851,1,1,1,0,1,4
4852,1,0,1,0,2,4
4853,0,2,1,0,1,4
4854,1,1,1,0,1,4
4855,1,1,1,0,1,4
4856,1,0,1,1,1,4
4857,0,1,1,1,1,4
4858,1,1,1,0,1,4
4859,0,2,2,0,0,4
4860,1,1,1,0,1,4
4861,1,1,1,0,1,4
4862,0,1,2,0,1,4
4863,0,2,1,0,1,4
4864,1,1,1,0,1,4
4865,0,2,1,0,1,4
4866,1,1,1,0,1,4
4867,0,1,1,1,1,4
4868,1,1,1,0,1,4
4869,1,1,1,0,1,4
4870,1,1,1,0,1,4
4871,0,2,2,0,0,4
4872,0,1,1,1,1,4
4873,1,1,1,0,1,4
4874,1,1,1,0,1,4
4875,0,1,1,1,1,4
4876,1,1,1,0,1,4
4877,1,1,1,0,1,4
4878,0,1,2,0,1,4
4879,0,1,1,0,2,4
4880,1,1,1,0,1,4
4881,0,1,1,0,2,4
4882,1,0,1,1,1,4
4883,1,1,1,1,0,4
4884,1,1,1,1,0,4
4885,0,1,2,1,0,4
4886,1,1,1,0,1,4
4887,1,1,1,0,1,4
4888,1,1,1,0,1,4
4889,1,1,1,0,1,4
4890,1,0,1,1,1,4
4891,1,1,1,0,1,4
4892,0,1,1,1,1,4
4893,1,1,1,0,1,4
4894,0,0,3,0,1,4
4895,1,1,1,0,1,4
4896,1,1,1,0,1,4
4897,1,1,1,0,1,4
4898,1,1,1,0,1,4
4899,0,0,1,3,0,4
4900,1,1,1,0,1,4
4901,0,1,2,0,1,4
4902,1,1,1,0,1,4
4903,1,0,1,1,1,4
4904,1,1,1,0,1,4
4905,0,1,1,0,2,4
4906,0,0,2,1,1,4
4907,1,1,1,1,0,4
4908,1,1,1,1,0,4
4909,1,0,1,1,1,4
4910,0,0,4,0,0,4
4911,1,1,2,0,0,4
4912,1,1,1,0,1,4
4913,1,1,1,0,1,4
4914,1,1,1,0,1,4
4915,1,1,1,0,1,4
4916,1,1,1,0,1,4
4917,0,1,2,0,1,4
4918,1,1,1,0,1,4
4919,0,1,1,1,1,4
4920,0,1,1,0,2,4
4921,1,1,1,0,1,4
4922,1,1,1,0,1,4
4923,1,1,1,0,1,4
4924,1,0,1,2,0,4
4925,1,1,1,0,1,4
4926,2,0,2,0,0,4
4927,0,2,1,0,1,4
4928,1,1,1,0,1,4
4929,0,0,3,0,1,4
4930,1,0,1,1,1,4
4931,0,1,1,0,2,4
4932,1,1,1,0,1,4
4933,1,1,1,0,1,4
4934,1,1,1,0,1,4
4935,0,2,1,0,1,4
4936,0,0,0,4,0,4
4937,0,1,1,1,1,4
4938,1,1,1,1,0,4
4939,0,0,0,4,0,4
4940,0,1,1,2,0,4
4941,0,0,0,4,0,4
4942,0,0,0,4,0,4
4943,0,0,0,4,0,4
4944,0,0,0,4,0,4
4945,0,1,1,1,1,4
4946,0,1,1,1,1,4
4947,1,0,0,1,2,4
4948,0,1,2,1,0,4
4949,1,1,0,1,1,4
4950,0,0,0,4,0,4
4951,1,0,0,3,0,4
4952,0,0,0,3,1,4
4953,0,0,0,4,0,4
4954,1,0,0,1,2,4
4955,1,0,0,0,3,4
4956,1,1,1,0,1,4
4957,0,0,1,0,3,4
4958,1,1,1,0,1,4
4959,1,1,1,0,1,4
4960,1,1,1,0,1,4
4961,0,1,1,1,1,4
4962,0,0,0,0,4,4
4963,0,1,2,0,1,4
4964,0,1,1,1,1,4
4965,1,1,1,0,1,4
4966,0,1,1,1,1,4
4967,1,1,1,0,1,4
4968,1,1,1,0,1,4
4969,1,1,1,0,1,4
4970,1,1,1,0,1,4
4971,0,1,1,1,1,4
4972,1,1,1,0,1,4
4973,1,1,1,0,1,4
4974,1,1,1,0,1,4
4975,1,1,1,0,1,4
4976,0,2,2,0,0,4
4977,0,1,2,0,1,4
4978,0,1,1,1,1,4
4979,0,2,2,0,0,4
4980,0,4,0,0,0,4
4981,0,3,1,0,0,4
4982,0,2,1,0,1,4
4983,0,2,1,0,1,4
4984,0,1,1,1,1,4
4985,0,2,2,0,0,4
4986,0,4,0,0,0,4
4987,0,1,1,0,2,4
4988,0,1,1,1,1,4
4989,0,1,1,1,1,4
4990,0,2,2,0,0,4
4991,0,1,1,1,1,4
4992,0,2,1,0,1,4
4993,0,4,0,0,0,4
4994,0,2,2,0,0,4
4995,0,3,1,0,0,4
4996,0,2,1,0,1,4
4997,0,2,2,0,0,4
4998,0,1,1,1,1,4
4999,0,1,1,1,1,4
5000,0,2,2,0,0,4
5001,0,1,1,0,2,4
5002,0,2,1,0,1,4
5003,0,3,1,0,0,4
5004,0,2,2,0,0,4
5005,0,1,1,1,1,4
5006,0,2,1,0,1,4
5007,0,1,1,0,2,4
5008,0,1,1,1,1,4
5009,0,2,1,1,0,4
5010,0,2,2,0,0,4
5011,0,1,1,0,2,4
5012,0,4,0,0,0,4
5013,0,2,2,0,0,4
5014,0,1,1,1,1,4
5015,0,2,1,0,1,4
5016,0,2,1,0,1,4
5017,0,1,1,1,1,4
5018,0,1,1,1,1,4
5019,0,1,1,1,1,4
5020,0,1,1,1,1,4
5021,0,4,0,0,0,4
5022,0,2,1,0,1,4
5023,0,4,0,0,0,4
5024,0,1,1,1,1,4
5025,0,3,1,0,0,4
5026,0,3,1,0,0,4
5027,0,1,1,1,1,4
5028,0,1,1,1,1,4
5029,0,1,1,1,1,4
5030,0,2,2,0,0,4
5031,0,2,1,0,1,4
5032,0,3,1,0,0,4
5033,0,4,0,0,0,4
5034,0,1,1,1,1,4
5035,0,3,1,0,0,4
5036,0,2,2,0,0,4
5037,0,2,1,0,1,4
5038,0,3,1,0,0,4
5039,0,1,1,1,1,4
5040,0,1,1,1,1,4
5041,0,1,1,0,2,4
5042,0,4,0,0,0,4
5043,0,4,0,0,0,4
5044,0,1,2,0,1,4
5045,0,2,2,0,0,4
5046,0,3,1,0,0,4
5047,0,3,1,0,0,4
5048,0,2,1,0,1,4
5049,0,3,1,0,0,4
5050,0,2,2,0,0,4
5051,0,3,1,0,0,4
5052,0,1,1,1,1,4
5053,0,1,1,1,1,4
5054,0,1,2,0,1,4
5055,0,1,1,1,1,4
5056,0,2,2,0,0,4
5057,0,1,1,2,0,4
5058,0,1,1,0,2,4
5059,0,1,1,0,2,4
5060,0,1,1,1,1,4
5061,0,1,2,0,1,4
5062,0,2,2,0,0,4
5063,0,1,1,0,2,4
5064,0,1,1,1,1,4
5065,0,1,1,1,1,4
5066,0,1,1,0,2,4
5067,0,1,1,1,1,4
5068,0,2,1,0,1,4
5069,0,1,1,1,1,4
5070,0,1,1,0,2,4
5071,0,1,1,1,1,4
5072,0,1,1,1,1,4
5073,0,2,2,0,0,4
5074,0,1,1,1,1,4
5075,0,1,1,1,1,4
5076,0,1,2,0,1,4
5077,0,1,1,1,1,4
5078,0,2,1,0,1,4
5079,0,0,4,0,0,4
5080,0,1,1,1,1,4
5081,0,1,1,1,1,4
5082,0,2,1,0,1,4
5083,0,2,1,0,1,4
5084,0,2,1,0,1,4
5085,0,1,1,0,2,4
5086,0,1,1,1,1,4
5087,0,1,1,1,1,4
5088,0,2,2,0,0,4
5089,0,1,1,1,1,4
5090,0,1,1,1,1,4
5091,0,1,1,0,2,4
5092,0,1,1,1,1,4
5093,0,1,1,1,1,4
5094,0,1,1,1,1,4
5095,0,1,1,0,2,4
5096,0,2,2,0,0,4
5097,0,0,4,0,0,4
5098,0,1,1,0,2,4
5099,0,2,1,0,1,4
5100,0,1,1,1,1,4
5101,0,2,2,0,0,4
5102,0,1,1,1,1,4
5103,0,2,1,0,1,4
5104,0,1,3,0,0,4
5105,0,1,1,0,2,4
5106,0,1,1,0,2,4
5107,0,1,1,1,1,4
5108,0,1,3,0,0,4
5109,0,1,1,1,1,4
5110,0,1,3,0,0,4
5111,0,1,1,1,1,4
5112,0,1,1,1,1,4
5113,0,1,1,1,1,4
5114,0,2,1,0,1,4
5115,0,1,1,1,1,4
5116,0,1,1,0,2,4
5117,0,1,1,1,1,4
5118,0,1,1,1,1,4
5119,0,1,1,1,1,4
5120,0,1,1,0,2,4
5121,0,2,2,0,0,4
5122,0,1,2,0,1,4
5123,0,1,1,1,1,4
5124,0,1,1,1,1,4
5125,0,1,1,1,1,4
5126,0,2,1,0,1,4
5127,0,3,1,0,0,4
5128,0,1,1,1,1,4
5129,0,1,1,1,1,4
5130,0,1,1,1,1,4
5131,0,1,1,1,1,4
5132,0,1,1,2,0,4
5133,0,1,1,1,1,4
5134,0,1,1,1,1,4
5135,0,2,1,0,1,4
5136,0,2,1,0,1,4
5137,0,1,1,1,1,4
5138,0,1,1,1,1,4
5139,0,1,1,1,1,4
5140,0,1,1,1,1,4
5141,0,1,1,1,1,4
5142,0,1,1,1,1,4
5143,0,1,1,0,2,4
5144,0,1,1,1,1,4
5145,0,1,1,0,2,4
5146,0,0,0,4,0,4
5147,0,0,0,0,4,4
5148,0,0,0,0,4,4
5149,0,0,4,0,0,4
5150,0,0,4,0,0,4
5151,0,0,4,0,0,4
5152,0,0,4,0,0,4
5153,0,0,4,0,0,4
5154,0,0,0,0,4,4
5155,0,0,0,4,0,4
5156,0,0,0,4,0,4
5157,0,0,0,4,0,4
5158,0,0,0,3,1,4
5159,0,0,0,4,0,4
5160,0,0,0,4,0,4
5161,0,0,0,4,0,4
5162,0,0,0,0,4,4
5163,0,0,0,0,4,4
5164,0,0,0,0,4,4
5165,0,0,0,0,4,4
5166,0,0,0,0,4,4
5167,0,0,0,0,4,4
5168,0,0,0,0,4,4
5169,0,0,0,0,4,4
5170,0,0,0,0,4,4
5171,0,0,0,0,4,4
5172,0,0,0,0,4,4
5173,0,0,0,0,4,4
5174,0,0,0,0,4,4
5175,1,1,1,0,0,3
5176,3,0,0,0,0,3
5177,3,0,0,0,0,3
5178,1,2,0,0,0,3
5179,2,0,0,1,0,3
5180,1,1,1,0,0,3
5181,3,0,0,0,0,3
5182,1,0,1,1,0,3
5183,1,1,1,0,0,3
5184,1,1,1,0,0,3
5185,1,0,1,0,1,3
5186,3,0,0,0,0,3
5187,1,1,1,0,0,3
5188,1,1,1,0,0,3
5189,1,0,0,0,2,3
5190,1,1,0,0,1,3
5191,1,1,1,0,0,3
5192,1,1,1,0,0,3
5193,1,1,0,0,1,3
5194,1,0,1,1,0,3
5195,1,0,0,2,0,3
5196,1,1,1,0,0,3
5197,1,0,1,0,1,3
5198,1,1,0,0,1,3
5199,1,1,1,0,0,3
5200,1,0,0,2,0,3
5201,2,0,0,1,0,3
5202,3,0,0,0,0,3
5203,2,0,0,0,1,3
5204,3,0,0,0,0,3
5205,1,0,1,1,0,3
5206,1,1,0,1,0,3
5207,3,0,0,0,0,3
5208,1,1,1,0,0,3
5209,1,0,1,0,1,3
5210,1,1,1,0,0,3
5211,1,1,1,0,0,3
5212,1,0,0,2,0,3
5213,1,1,1,0,0,3
5214,1,1,1,0,0,3
5215,1,1,1,0,0,3
5216,1,1,1,0,0,3
5217,1,1,1,0,0,3
5218,2,0,0,1,0,3
5219,3,0,0,0,0,3
5220,3,0,0,0,0,3
5221,1,0,1,0,1,3
5222,2,0,0,1,0,3
5223,3,0,0,0,0,3
5224,3,0,0,0,0,3
5225,3,0,0,0,0,3
5226,1,1,1,0,0,3
5227,2,0,0,1,0,3
5228,2,0,1,0,0,3
5229,1,1,1,0,0,3
5230,3,0,0,0,0,3
5231,1,1,1,0,0,3
5232,1,1,1,0,0,3
5233,3,0,0,0,0,3
5234,1,1,1,0,0,3
5235,3,0,0,0,0,3
5236,3,0,0,0,0,3
5237,3,0,0,0,0,3
5238,1,0,1,0,1,3
5239,1,1,1,0,0,3
5240,1,1,1,0,0,3
5241,2,0,0,1,0,3
5242,1,1,1,0,0,3
5243,2,0,0,1,0,3
5244,1,1,1,0,0,3
5245,2,0,0,1,0,3
5246,1,1,1,0,0,3
5247,1,1,1,0,0,3
5248,1,1,1,0,0,3
5249,1,1,1,0,0,3
5250,1,1,1,0,0,3
5251,1,1,0,0,1,3
5252,1,1,1,0,0,3
5253,2,0,1,0,0,3
5254,1,1,0,0,1,3
5255,1,1,1,0,0,3
5256,1,0,1,0,1,3
5257,1,1,1,0,0,3
5258,3,0,0,0,0,3
5259,2,0,0,1,0,3
5260,1,1,1,0,0,3
5261,3,0,0,0,0,3
5262,3,0,0,0,0,3
5263,1,1,1,0,0,3
5264,3,0,0,0,0,3
5265,3,0,0,0,0,3
5266,3,0,0,0,0,3
5267,1,0,0,2,0,3
5268,1,2,0,0,0,3
5269,1,1,1,0,0,3
5270,1,1,1,0,0,3
5271,3,0,0,0,0,3
5272,1,1,1,0,0,3
5273,1,1,1,0,0,3
5274,1,0,0,2,0,3
5275,1,0,1,0,1,3
5276,1,1,1,0,0,3
5277,1,1,0,1,0,3
5278,1,0,1,0,1,3
5279,1,1,1,0,0,3
5280,1,0,1,1,0,3
5281,1,0,0,2,0,3
5282,2,0,0,0,1,3
5283,3,0,0,0,0,3
5284,1,1,1,0,0,3
5285,1,1,1,0,0,3
5286,2,0,0,0,1,3
5287,2,0,1,0,0,3
5288,2,0,0,1,0,3
5289,3,0,0,0,0,3
5290,1,1,1,0,0,3
5291,2,0,0,1,0,3
5292,2,0,0,1,0,3
5293,1,1,1,0,0,3
5294,1,1,1,0,0,3
5295,3,0,0,0,0,3
5296,3,0,0,0,0,3
5297,1,1,1,0,0,3
5298,2,0,0,0,1,3
5299,1,0,0,2,0,3
5300,1,1,1,0,0,3
5301,1,1,1,0,0,3
5302,1,0,0,1,1,3
5303,2,0,0,0,1,3
5304,1,0,0,2,0,3
5305,3,0,0,0,0,3
5306,1,1,1,0,0,3
5307,3,0,0,0,0,3
5308,1,0,0,0,2,3
5309,1,1,1,0,0,3
5310,1,1,1,0,0,3
5311,1,1,1,0,0,3
5312,1,1,1,0,0,3
5313,1,1,1,0,0,3
5314,2,0,0,1,0,3
5315,1,1,0,1,0,3
5316,1,1,1,0,0,3
5317,1,1,1,0,0,3
5318,1,0,1,0,1,3
5319,1,1,0,0,1,3
5320,1,1,1,0,0,3
5321,1,1,1,0,0,3
5322,2,0,0,1,0,3
5323,1,1,1,0,0,3
5324,1,1,1,0,0,3
5325,3,0,0,0,0,3
5326,1,1,1,0,0,3
5327,1,1,1,0,0,3
5328,3,0,0,0,0,3
5329,2,0,0,1,0,3
5330,1,1,1,0,0,3
5331,1,1,1,0,0,3
5332,1,1,1,0,0,3
5333,1,1,1,0,0,3
5334,1,1,1,0,0,3
5335,2,0,0,1,0,3
5336,3,0,0,0,0,3
5337,1,1,1,0,0,3
5338,1,1,1,0,0,3
5339,2,0,0,1,0,3
5340,3,0,0,0,0,3
5341,3,0,0,0,0,3
5342,1,1,1,0,0,3
5343,1,1,1,0,0,3
5344,2,0,0,1,0,3
5345,3,0,0,0,0,3
5346,3,0,0,0,0,3
5347,1,1,1,0,0,3
5348,1,1,0,1,0,3
5349,2,0,0,0,1,3
5350,3,0,0,0,0,3
5351,3,0,0,0,0,3
5352,2,0,0,1,0,3
5353,1,0,1,0,1,3
5354,1,1,1,0,0,3
5355,1,1,1,0,0,3
5356,2,1,0,0,0,3
5357,2,0,0,1,0,3
5358,1,0,0,2,0,3
5359,3,0,0,0,0,3
5360,2,0,0,1,0,3
5361,2,0,0,1,0,3
5362,2,0,0,0,1,3
5363,1,1,0,0,1,3
5364,3,0,0,0,0,3
5365,1,1,1,0,0,3
5366,1,1,1,0,0,3
5367,2,0,0,1,0,3
5368,1,1,1,0,0,3
5369,3,0,0,0,0,3
5370,3,0,0,0,0,3
5371,1,1,1,0,0,3
5372,3,0,0,0,0,3
5373,2,0,0,1,0,3
5374,1,1,1,0,0,3
5375,1,1,1,0,0,3
5376,3,0,0,0,0,3
5377,2,0,0,0,1,3
5378,3,0,0,0,0,3
5379,2,0,0,0,1,3
5380,1,0,1,0,1,3
5381,3,0,0,0,0,3
5382,3,0,0,0,0,3
5383,1,1,1,0,0,3
5384,2,0,0,1,0,3
5385,3,0,0,0,0,3
5386,2,0,1,0,0,3
5387,1,1,1,0,0,3
5388,3,0,0,0,0,3
5389,2,0,0,0,1,3
5390,2,0,0,1,0,3
5391,1,1,1,0,0,3
5392,2,0,0,1,0,3
5393,3,0,0,0,0,3
5394,3,0,0,0,0,3
5395,1,0,1,0,1,3
5396,3,0,0,0,0,3
5397,1,0,0,2,0,3
5398,1,1,1,0,0,3
5399,3,0,0,0,0,3
5400,2,0,0,0,1,3
5401,1,1,1,0,0,3
5402,1,1,0,1,0,3
5403,3,0,0,0,0,3
5404,1,1,1,0,0,3
5405,1,1,1,0,0,3
5406,1,0,1,1,0,3
5407,3,0,0,0,0,3
5408,2,1,0,0,0,3
5409,2,0,0,1,0,3
5410,2,0,1,0,0,3
5411,3,0,0,0,0,3
5412,3,0,0,0,0,3
5413,1,1,1,0,0,3
5414,1,1,1,0,0,3
5415,1,1,1,0,0,3
5416,3,0,0,0,0,3
5417,1,1,1,0,0,3
5418,2,1,0,0,0,3
5419,3,0,0,0,0,3
5420,1,0,1,0,1,3
5421,2,0,0,0,1,3
5422,1,1,1,0,0,3
5423,1,1,1,0,0,3
5424,1,1,1,0,0,3
5425,1,1,0,1,0,3
5426,1,1,1,0,0,3
5427,3,0,0,0,0,3
5428,1,1,1,0,0,3
5429,3,0,0,0,0,3
5430,1,1,0,1,0,3
5431,0,1,1,0,1,3
5432,1,1,1,0,0,3
5433,0,1,1,0,1,3
5434,1,1,0,0,1,3
5435,1,1,1,0,0,3
5436,1,1,1,0,0,3
5437,0,1,1,0,1,3
5438,1,1,1,0,0,3
5439,1,1,1,0,0,3
5440,1,1,1,0,0,3
5441,0,1,1,0,1,3
5442,0,1,1,0,1,3
5443,0,1,1,0,1,3
5444,1,1,1,0,0,3
5445,1,1,1,0,0,3
5446,1,1,1,0,0,3
5447,0,1,1,0,1,3
5448,0,1,1,0,1,3
5449,0,1,1,0,1,3
5450,0,1,1,0,1,3
5451,0,1,1,0,1,3
5452,1,1,1,0,0,3
5453,0,1,1,0,1,3
5454,1,1,1,0,0,3
5455,1,1,1,0,0,3
5456,1,1,1,0,0,3
5457,0,2,0,0,1,3
5458,0,2,0,0,1,3
5459,1,1,1,0,0,3
5460,0,1,1,0,1,3
5461,0,1,1,0,1,3
5462,0,1,1,1,0,3
5463,0,1,1,0,1,3
5464,1,1,1,0,0,3
5465,1,1,0,0,1,3
5466,1,1,1,0,0,3
5467,1,1,1,0,0,3
5468,1,1,1,0,0,3
5469,1,1,1,0,0,3
5470,1,1,0,0,1,3
5471,0,1,1,0,1,3
5472,1,1,1,0,0,3
5473,0,1,1,0,1,3
5474,0,2,0,0,1,3
5475,0,1,1,1,0,3
5476,1,1,1,0,0,3
5477,0,1,1,0,1,3
5478,1,1,0,0,1,3
5479,0,1,1,0,1,3
5480,0,1,1,1,0,3
5481,1,1,1,0,0,3
5482,1,1,1,0,0,3
5483,1,1,1,0,0,3
5484,1,1,1,0,0,3
5485,1,1,1,0,0,3
5486,0,1,1,0,1,3
5487,1,1,1,0,0,3
5488,1,1,1,0,0,3
5489,1,1,1,0,0,3
5490,1,1,1,0,0,3
5491,1,1,1,0,0,3
5492,0,1,1,0,1,3
5493,0,1,1,0,1,3
5494,1,1,0,0,1,3
5495,1,1,1,0,0,3
5496,1,1,1,0,0,3
5497,1,1,0,0,1,3
5498,1,1,1,0,0,3
5499,0,1,1,0,1,3
5500,0,2,1,0,0,3
5501,0,1,1,0,1,3
5502,1,1,1,0,0,3
5503,0,1,1,0,1,3
5504,1,1,0,0,1,3
5505,0,1,1,0,1,3
5506,0,1,1,0,1,3
5507,1,1,1,0,0,3
5508,1,1,1,0,0,3
5509,0,1,1,0,1,3
5510,1,1,1,0,0,3
5511,0,1,1,0,1,3
5512,1,1,1,0,0,3
5513,1,1,1,0,0,3
5514,0,1,1,0,1,3
5515,1,1,1,0,0,3
5516,0,1,1,0,1,3
5517,0,1,1,0,1,3
5518,0,1,1,0,1,3
5519,0,2,1,0,0,3
5520,1,1,1,0,0,3
5521,1,1,1,0,0,3
5522,1,0,0,2,0,3
5523,1,1,0,0,1,3
5524,1,1,1,0,0,3
5525,1,1,1,0,0,3
5526,0,1,1,0,1,3
5527,0,1,1,0,1,3
5528,1,1,1,0,0,3
5529,1,1,1,0,0,3
5530,1,1,1,0,0,3
5531,0,1,1,0,1,3
5532,1,1,1,0,0,3
5533,0,2,1,0,0,3
5534,0,3,0,0,0,3
5535,0,1,1,0,1,3
5536,1,1,1,0,0,3
5537,0,1,1,0,1,3
5538,1,1,0,1,0,3
5539,0,2,1,0,0,3
5540,1,1,1,0,0,3
5541,1,1,1,0,0,3
5542,1,1,1,0,0,3
5543,0,1,1,1,0,3
5544,0,1,1,0,1,3
5545,0,1,1,0,1,3
5546,1,1,1,0,0,3
5547,1,1,1,0,0,3
5548,1,1,1,0,0,3
5549,0,2,1,0,0,3
5550,1,1,1,0,0,3
5551,0,1,1,0,1,3
5552,0,2,1,0,0,3
5553,1,1,0,1,0,3
5554,1,1,1,0,0,3
5555,1,1,1,0,0,3
5556,1,1,1,0,0,3
5557,1,1,1,0,0,3
5558,1,1,1,0,0,3
5559,1,1,1,0,0,3
5560,1,1,1,0,0,3
5561,1,1,1,0,0,3
5562,0,1,1,0,1,3
5563,1,1,1,0,0,3
5564,1,1,1,0,0,3
5565,0,3,0,0,0,3
5566,1,1,1,0,0,3
5567,0,1,1,0,1,3
5568,1,1,1,0,0,3
5569,1,1,1,0,0,3
5570,0,1,1,0,1,3
5571,1,1,1,0,0,3
5572,1,1,1,0,0,3
5573,1,1,1,0,0,3
5574,1,1,1,0,0,3
5575,0,1,1,0,1,3
5576,1,1,1,0,0,3
5577,1,1,1,0,0,3
5578,1,1,1,0,0,3
5579,1,1,1,0,0,3
5580,0,1,1,0,1,3
5581,1,1,0,0,1,3
5582,1,1,1,0,0,3
5583,1,1,1,0,0,3
5584,1,1,1,0,0,3
5585,0,1,1,0,1,3
5586,1,1,1,0,0,3
5587,1,1,1,0,0,3
5588,1,1,1,0,0,3
5589,0,2,1,0,0,3
5590,0,1,2,0,0,3
5591,1,1,0,1,0,3
5592,1,1,1,0,0,3
5593,0,1,1,0,1,3
5594,1,0,1,0,1,3
5595,0,1,1,0,1,3
5596,1,1,1,0,0,3
5597,1,1,1,0,0,3
5598,0,1,1,0,1,3
5599,0,1,1,0,1,3
5600,1,1,1,0,0,3
5601,1,1,0,0,1,3
5602,1,1,1,0,0,3
5603,0,1,1,0,1,3
5604,0,1,1,0,1,3
5605,1,0,0,0,2,3
5606,0,1,1,0,1,3
5607,0,1,1,0,1,3
5608,1,1,1,0,0,3
5609,0,1,1,0,1,3
5610,1,1,1,0,0,3
5611,0,1,1,0,1,3
5612,1,1,1,0,0,3
5613,1,1,1,0,0,3
5614,0,1,1,0,1,3
5615,0,1,1,0,1,3
5616,0,1,1,0,1,3
5617,1,1,1,0,0,3
5618,1,1,1,0,0,3
5619,1,1,0,0,1,3
5620,0,1,1,0,1,3
5621,0,1,1,0,1,3
5622,1,1,1,0,0,3
5623,1,1,1,0,0,3
5624,1,1,1,0,0,3
5625,0,1,1,0,1,3
5626,0,1,1,0,1,3
5627,1,1,1,0,0,3
5628,1,1,1,0,0,3
5629,1,1,1,0,0,3
5630,1,1,0,1,0,3
5631,0,1,1,0,1,3
5632,0,1,1,0,1,3
5633,0,1,1,0,1,3
5634,1,1,1,0,0,3
5635,0,1,1,0,1,3
5636,0,1,1,0,1,3
5637,1,1,1,0,0,3
5638,1,1,1,0,0,3
5639,0,2,1,0,0,3
5640,0,1,1,0,1,3
5641,1,1,1,0,0,3
5642,1,1,1,0,0,3
5643,0,1,1,0,1,3
5644,0,2,1,0,0,3
5645,0,1,1,0,1,3
5646,0,1,1,0,1,3
5647,1,1,1,0,0,3
5648,1,1,0,0,1,3
5649,1,1,1,0,0,3
5650,1,1,1,0,0,3
5651,1,1,1,0,0,3
5652,1,1,1,0,0,3
5653,1,1,1,0,0,3
5654,0,1,1,1,0,3
5655,0,1,1,0,1,3
5656,1,1,0,0,1,3
5657,0,1,1,1,0,3
5658,0,1,1,0,1,3
5659,1,1,1,0,0,3
5660,0,1,1,0,1,3
5661,1,1,0,0,1,3
5662,1,1,1,0,0,3
5663,0,1,0,0,2,3
5664,1,1,1,0,0,3
5665,1,1,1,0,0,3
5666,0,1,1,0,1,3
5667,1,1,1,0,0,3
5668,1,1,1,0,0,3
5669,0,1,1,0,1,3
5670,1,1,1,0,0,3
5671,0,1,1,0,1,3
5672,0,1,1,0,1,3
5673,0,1,1,0,1,3
5674,1,1,1,0,0,3
5675,1,1,1,0,0,3
5676,1,1,1,0,0,3
5677,0,1,1,0,1,3
5678,0,1,1,0,1,3
5679,0,1,1,0,1,3
5680,0,2,1,0,0,3
5681,0,1,1,0,1,3
5682,1,1,1,0,0,3
5683,0,1,2,0,0,3
5684,1,1,1,0,0,3
5685,0,1,1,0,1,3
5686,1,1,1,0,0,3
5687,0,1,1,0,1,3
5688,0,1,1,0,1,3
5689,0,2,1,0,0,3
5690,0,1,1,0,1,3
5691,1,0,1,0,1,3
5692,0,1,1,0,1,3
5693,0,1,1,0,1,3
5694,1,1,1,0,0,3
5695,1,1,1,0,0,3
5696,1,1,1,0,0,3
5697,1,1,0,0,1,3
5698,1,1,1,0,0,3
5699,1,1,1,0,0,3
5700,1,1,1,0,0,3
5701,1,1,1,0,0,3
5702,1,1,1,0,0,3
5703,1,1,1,0,0,3
5704,0,1,1,1,0,3
5705,0,1,1,0,1,3
5706,1,1,1,0,0,3
5707,0,1,1,0,1,3
5708,1,1,0,0,1,3
5709,0,1,1,0,1,3
5710,1,1,1,0,0,3
5711,1,1,1,0,0,3
5712,0,1,1,0,1,3
5713,1,1,1,0,0,3
5714,1,1,1,0,0,3
5715,1,1,0,0,1,3
5716,0,1,1,1,0,3
5717,1,1,1,0,0,3
5718,1,1,1,0,0,3
5719,1,1,1,0,0,3
5720,0,1,1,0,1,3
5721,1,1,1,0,0,3
5722,0,1,1,0,1,3
5723,0,1,1,0,1,3
5724,0,1,1,0,1,3
5725,0,1,1,0,1,3
5726,1,1,0,1,0,3
5727,0,1,1,0,1,3
5728,0,2,1,0,0,3
5729,0,1,1,0,1,3
5730,1,1,1,0,0,3
5731,0,2,1,0,0,3
5732,1,1,0,0,1,3
5733,0,1,1,0,1,3
5734,0,1,1,0,1,3
5735,0,1,1,0,1,3
5736,0,1,1,0,1,3
5737,1,1,1,0,0,3
5738,0,1,1,0,1,3
5739,0,1,1,0,1,3
5740,0,1,1,0,1,3
5741,1,0,1,1,0,3
5742,1,1,1,0,0,3
5743,1,1,1,0,0,3
5744,0,1,1,0,1,3
5745,1,0,0,2,0,3
5746,0,2,1,0,0,3
5747,0,2,1,0,0,3
5748,0,1,1,0,1,3
5749,1,1,0,1,0,3
5750,1,1,1,0,0,3
5751,1,1,1,0,0,3
5752,1,1,1,0,0,3
5753,0,1,1,0,1,3
5754,0,1,1,0,1,3
5755,1,1,1,0,0,3
5756,1,1,1,0,0,3
5757,1,1,1,0,0,3
5758,0,1,1,0,1,3
5759,1,1,1,0,0,3
5760,1,1,1,0,0,3
5761,1,1,0,0,1,3
5762,1,1,1,0,0,3
5763,1,1,1,0,0,3
5764,1,1,1,0,0,3
5765,1,1,1,0,0,3
5766,0,1,1,1,0,3
5767,1,1,1,0,0,3
5768,1,1,1,0,0,3
5769,1,1,1,0,0,3
5770,1,1,1,0,0,3
5771,1,1,1,0,0,3
5772,1,1,1,0,0,3
5773,0,1,1,1,0,3
5774,0,1,1,0,1,3
5775,1,1,0,1,0,3
5776,0,1,1,0,1,3
5777,1,1,1,0,0,3
5778,1,1,1,0,0,3
5779,1,1,1,0,0,3
5780,1,1,1,0,0,3
5781,0,2,0,0,1,3
5782,0,1,1,0,1,3
5783,1,1,0,0,1,3
5784,0,1,1,0,1,3
5785,0,2,1,0,0,3
5786,1,0,0,2,0,3
5787,0,1,1,0,1,3
5788,0,1,1,0,1,3
5789,0,1,1,0,1,3
5790,1,1,1,0,0,3
5791,1,1,1,0,0,3
5792,1,1,1,0,0,3
5793,0,1,1,0,1,3
5794,0,2,1,0,0,3
5795,0,1,1,0,1,3
5796,1,1,1,0,0,3
5797,1,1,1,0,0,3
5798,1,1,1,0,0,3
5799,0,1,1,0,1,3
5800,1,1,0,0,1,3
5801,0,1,1,0,1,3
5802,1,1,1,0,0,3
5803,0,3,0,0,0,3
5804,1,0,0,2,0,3
5805,1,1,1,0,0,3
5806,1,1,1,0,0,3
5807,1,1,1,0,0,3
5808,0,1,0,1,1,3
5809,1,1,1,0,0,3
5810,1,1,1,0,0,3
5811,0,1,1,0,1,3
5812,0,2,1,0,0,3
5813,0,1,1,0,1,3
5814,0,2,1,0,0,3
5815,1,1,1,0,0,3
5816,0,2,1,0,0,3
5817,0,1,1,0,1,3
5818,1,1,1,0,0,3
5819,0,1,1,0,1,3
5820,1,1,1,0,0,3
5821,1,1,1,0,0,3
5822,1,1,1,0,0,3
5823,0,1,1,0,1,3
5824,0,1,0,0,2,3
5825,1,1,1,0,0,3
5826,0,1,1,0,1,3
5827,0,1,1,0,1,3
5828,0,2,1,0,0,3
5829,0,2,1,0,0,3
5830,1,1,1,0,0,3
5831,1,1,1,0,0,3
5832,1,1,1,0,0,3
5833,0,1,1,0,1,3
5834,0,1,1,0,1,3
5835,0,1,1,0,1,3
5836,1,1,1,0,0,3
5837,0,1,1,0,1,3
5838,0,1,1,0,1,3
5839,1,1,1,0,0,3
5840,1,1,0,0,1,3
5841,1,1,0,0,1,3
5842,0,1,2,0,0,3
5843,0,1,1,0,1,3
5844,1,1,0,0,1,3
5845,0,2,1,0,0,3
5846,0,1,1,0,1,3
5847,1,1,1,0,0,3
5848,0,1,0,0,2,3
5849,0,1,0,1,1,3
5850,1,1,1,0,0,3
5851,1,1,1,0,0,3
5852,1,1,1,0,0,3
5853,0,1,1,0,1,3
5854,0,1,1,0,1,3
5855,1,1,0,0,1,3
5856,0,2,1,0,0,3
5857,0,2,0,0,1,3
5858,1,1,1,0,0,3
5859,1,1,1,0,0,3
5860,1,1,1,0,0,3
5861,0,1,2,0,0,3
5862,1,1,0,0,1,3
5863,1,1,1,0,0,3
5864,1,1,1,0,0,3
5865,0,1,1,0,1,3
5866,0,1,1,0,1,3
5867,1,1,1,0,0,3
5868,1,1,1,0,0,3
5869,0,1,1,0,1,3
5870,1,1,1,0,0,3
5871,0,1,1,0,1,3
5872,0,1,2,0,0,3
5873,0,1,1,0,1,3
5874,0,1,1,0,1,3
5875,1,1,1,0,0,3
5876,1,1,1,0,0,3
5877,0,1,1,0,1,3
5878,1,1,0,0,1,3
5879,1,1,1,0,0,3
5880,1,1,1,0,0,3
5881,1,1,1,0,0,3
5882,0,1,1,0,1,3
5883,1,1,1,0,0,3
5884,1,1,0,0,1,3
5885,1,1,1,0,0,3
5886,0,1,1,0,1,3
5887,1,1,1,0,0,3
5888,1,1,1,0,0,3
5889,0,1,1,0,1,3
5890,1,1,0,0,1,3
5891,1,1,1,0,0,3
5892,1,1,1,0,0,3
5893,1,1,1,0,0,3
5894,1,1,1,0,0,3
5895,1,1,1,0,0,3
5896,0,1,1,0,1,3
5897,0,1,1,0,1,3
5898,1,1,1,0,0,3
5899,0,1,1,0,1,3
5900,1,1,0,0,1,3
5901,1,1,1,0,0,3
5902,1,1,0,0,1,3
5903,1,1,1,0,0,3
5904,0,1,1,0,1,3
5905,1,1,1,0,0,3
5906,0,1,1,0,1,3
5907,1,1,1,0,0,3
5908,0,1,1,0,1,3
5909,1,1,1,0,0,3
5910,1,1,1,0,0,3
5911,1,1,1,0,0,3
5912,0,1,1,0,1,3
5913,1,1,1,0,0,3
5914,0,2,1,0,0,3
5915,0,1,1,0,1,3
5916,0,1,2,0,0,3
5917,1,1,1,0,0,3
5918,1,1,1,0,0,3
5919,1,1,0,1,0,3
5920,0,1,1,1,0,3
5921,0,1,1,0,1,3
5922,0,1,1,0,1,3
5923,1,1,0,0,1,3
5924,1,1,1,0,0,3
5925,1,1,1,0,0,3
5926,1,1,1,0,0,3
5927,1,1,1,0,0,3
5928,0,1,1,0,1,3
5929,1,1,1,0,0,3
5930,0,1,1,0,1,3
5931,1,1,1,0,0,3
5932,0,1,1,0,1,3
5933,1,1,1,0,0,3
5934,1,1,1,0,0,3
5935,1,1,0,1,0,3
5936,1,1,1,0,0,3
5937,0,1,1,0,1,3
5938,0,1,1,0,1,3
5939,1,1,1,0,0,3
5940,0,1,1,0,1,3
5941,1,1,1,0,0,3
5942,0,1,1,0,1,3
5943,0,1,1,0,1,3
5944,0,1,2,0,0,3
5945,1,0,1,1,0,3
5946,0,2,1,0,0,3
5947,0,1,1,0,1,3
5948,0,1,1,0,1,3
5949,0,1,1,0,1,3
5950,0,1,1,0,1,3
5951,0,1,1,0,1,3
5952,1,1,1,0,0,3
5953,1,1,1,0,0,3
5954,0,1,1,0,1,3
5955,0,1,0,0,2,3
5956,1,1,1,0,0,3
5957,1,1,1,0,0,3
5958,1,1,1,0,0,3
5959,1,1,1,0,0,3
5960,0,1,1,1,0,3
5961,1,1,1,0,0,3
5962,1,1,1,0,0,3
5963,0,1,1,0,1,3
5964,1,1,1,0,0,3
5965,1,1,1,0,0,3
5966,1,1,1,0,0,3
5967,1,1,1,0,0,3
5968,1,1,1,0,0,3
5969,0,1,2,0,0,3
5970,1,0,1,1,0,3
5971,1,1,1,0,0,3
5972,1,1,1,0,0,3
5973,1,1,1,0,0,3
5974,1,1,1,0,0,3
5975,1,1,1,0,0,3
5976,1,1,1,0,0,3
5977,0,1,1,0,1,3
5978,1,1,1,0,0,3
5979,1,1,1,0,0,3
5980,0,1,1,0,1,3
5981,1,1,1,0,0,3
5982,0,1,1,0,1,3
5983,0,1,1,0,1,3
5984,1,1,1,0,0,3
5985,0,1,1,0,1,3
5986,1,1,1,0,0,3
5987,1,1,1,0,0,3
5988,0,1,1,0,1,3
5989,0,1,1,0,1,3
5990,1,1,1,0,0,3
5991,0,1,1,0,1,3
5992,1,1,1,0,0,3
5993,0,1,1,0,1,3
5994,1,1,1,0,0,3
5995,1,1,0,0,1,3
5996,0,1,2,0,0,3
5997,1,1,1,0,0,3
5998,0,1,1,1,0,3
5999,1,1,1,0,0,3
6000,0,1,1,0,1,3
6001,1,1,1,0,0,3
6002,0,1,1,0,1,3
6003,0,1,1,0,1,3
6004,0,1,1,0,1,3
6005,1,1,1,0,0,3
6006,0,1,1,0,1,3
6007,1,1,1,0,0,3
6008,0,1,1,0,1,3
6009,1,1,1,0,0,3
6010,1,1,0,0,1,3
6011,1,1,1,0,0,3
6012,0,3,0,0,0,3
6013,0,2,1,0,0,3
6014,1,1,1,0,0,3
6015,0,1,1,0,1,3
6016,0,1,1,0,1,3
6017,0,1,1,0,1,3
6018,0,1,1,0,1,3
6019,1,1,1,0,0,3
6020,0,1,1,1,0,3
6021,1,1,1,0,0,3
6022,1,1,0,0,1,3
6023,0,1,1,0,1,3
6024,0,1,1,0,1,3
6025,1,1,1,0,0,3
6026,0,1,1,0,1,3
6027,1,1,0,0,1,3
6028,1,1,1,0,0,3
6029,1,1,0,0,1,3
6030,1,1,1,0,0,3
6031,0,1,1,0,1,3
6032,0,1,1,0,1,3
6033,1,1,0,0,1,3
6034,1,1,1,0,0,3
6035,1,1,1,0,0,3
6036,0,1,1,0,1,3
6037,1,1,1,0,0,3
6038,0,1,1,0,1,3
6039,1,1,1,0,0,3
6040,0,1,1,0,1,3
6041,0,1,1,0,1,3
6042,1,1,0,0,1,3
6043,0,1,1,0,1,3
6044,0,1,1,0,1,3
6045,1,1,1,0,0,3
6046,0,1,1,0,1,3
6047,0,1,1,0,1,3
6048,0,1,1,0,1,3
6049,1,1,1,0,0,3
6050,1,1,0,0,1,3
6051,0,2,1,0,0,3
6052,1,1,1,0,0,3
6053,0,1,1,0,1,3
6054,0,3,0,0,0,3
6055,0,1,1,0,1,3
6056,0,1,1,0,1,3
6057,0,1,1,0,1,3
6058,1,1,1,0,0,3
6059,1,1,1,0,0,3
6060,1,1,1,0,0,3
6061,0,1,1,0,1,3
6062,0,1,1,0,1,3
6063,0,2,1,0,0,3
6064,0,1,1,0,1,3
6065,1,1,1,0,0,3
6066,1,1,1,0,0,3
6067,0,1,1,0,1,3
6068,1,1,1,0,0,3
6069,1,1,0,0,1,3
6070,1,1,1,0,0,3
6071,0,3,0,0,0,3
6072,0,1,1,0,1,3
6073,0,1,1,0,1,3
6074,1,1,1,0,0,3
6075,0,1,1,1,0,3
6076,0,1,1,0,1,3
6077,0,1,1,0,1,3
6078,0,2,1,0,0,3
6079,1,1,1,0,0,3
6080,1,1,1,0,0,3
6081,1,1,1,0,0,3
6082,1,1,0,1,0,3
6083,1,1,1,0,0,3
6084,0,2,1,0,0,3
6085,0,2,1,0,0,3
6086,0,2,1,0,0,3
6087,0,2,1,0,0,3
6088,0,1,1,0,1,3
6089,1,1,1,0,0,3
6090,0,1,1,0,1,3
6091,1,0,1,0,1,3
6092,0,1,1,0,1,3
6093,0,2,0,0,1,3
6094,1,1,0,0,1,3
6095,0,1,1,0,1,3
6096,0,1,1,0,1,3
6097,0,0,1,1,1,3
6098,1,1,1,0,0,3
6099,1,1,1,0,0,3
6100,0,1,1,0,1,3
6101,1,1,1,0,0,3
6102,0,0,1,1,1,3
6103,0,1,1,0,1,3
6104,1,0,1,0,1,3
6105,0,2,1,0,0,3
6106,0,1,1,1,0,3
6107,0,0,2,1,0,3
6108,0,1,1,1,0,3
6109,0,1,1,0,1,3
6110,0,1,1,0,1,3
6111,0,1,1,0,1,3
6112,1,1,1,0,0,3
6113,1,1,1,0,0,3
6114,1,1,1,0,0,3
6115,0,1,1,0,1,3
6116,1,0,2,0,0,3
6117,0,1,2,0,0,3
6118,1,0,1,0,1,3
6119,0,2,1,0,0,3
6120,0,1,1,0,1,3
6121,0,1,1,1,0,3
6122,2,0,0,1,0,3
6123,0,1,1,0,1,3
6124,0,1,1,0,1,3
6125,0,1,1,0,1,3
6126,1,0,1,0,1,3
6127,0,1,1,0,1,3
6128,0,1,1,0,1,3
6129,0,1,1,0,1,3
6130,0,1,1,0,1,3
6131,1,1,1,0,0,3
6132,0,1,1,0,1,3
6133,1,0,1,0,1,3
6134,0,2,1,0,0,3
6135,0,1,1,0,1,3
6136,0,1,1,0,1,3
6137,0,1,1,0,1,3
6138,0,1,1,0,1,3
6139,0,1,1,0,1,3
6140,1,1,1,0,0,3
6141,1,1,1,0,0,3
6142,1,0,2,0,0,3
6143,0,1,1,0,1,3
6144,0,1,1,0,1,3
6145,0,1,1,0,1,3
6146,0,0,1,2,0,3
6147,1,0,1,0,1,3
6148,1,1,1,0,0,3
6149,0,1,1,0,1,3
6150,1,0,1,0,1,3
6151,0,1,1,0,1,3
6152,1,0,1,0,1,3
6153,1,1,1,0,0,3
6154,0,1,1,0,1,3
6155,0,1,1,0,1,3
6156,0,1,1,0,1,3
6157,0,2,1,0,0,3
6158,1,1,1,0,0,3
6159,0,1,1,0,1,3
6160,0,1,1,0,1,3
6161,1,1,1,0,0,3
6162,0,1,1,0,1,3
6163,0,0,2,1,0,3
6164,1,0,0,2,0,3
6165,0,0,3,0,0,3
6166,0,1,1,0,1,3
6167,0,0,1,2,0,3
6168,0,1,1,0,1,3
6169,0,1,1,0,1,3
6170,1,0,1,0,1,3
6171,0,1,1,0,1,3
6172,0,1,1,0,1,3
6173,0,0,1,1,1,3
6174,2,0,1,0,0,3
6175,1,1,1,0,0,3
6176,0,0,1,1,1,3
6177,0,1,1,0,1,3
6178,0,0,1,1,1,3
6179,0,1,1,0,1,3
6180,1,0,1,0,1,3
6181,0,1,1,0,1,3
6182,0,1,1,0,1,3
6183,0,1,1,0,1,3
6184,0,1,2,0,0,3
6185,0,2,1,0,0,3
6186,0,1,1,0,1,3
6187,0,1,1,0,1,3
6188,0,1,1,0,1,3
6189,1,0,1,0,1,3
6190,0,0,1,0,2,3
6191,0,0,1,1,1,3
6192,0,1,1,0,1,3
6193,1,1,1,0,0,3
6194,1,0,1,0,1,3
6195,0,1,1,0,1,3
6196,0,0,1,2,0,3
6197,0,1,1,0,1,3
6198,0,1,1,0,1,3
6199,0,1,1,0,1,3
6200,1,1,1,0,0,3
6201,0,1,1,0,1,3
6202,1,1,1,0,0,3
6203,0,0,1,0,2,3
6204,0,1,1,0,1,3
6205,0,1,1,0,1,3
6206,0,1,1,0,1,3
6207,1,1,1,0,0,3
6208,0,1,1,0,1,3
6209,0,1,1,0,1,3
6210,1,1,1,0,0,3
6211,0,1,1,0,1,3
6212,0,1,1,0,1,3
6213,0,1,1,0,1,3
6214,0,1,1,0,1,3
6215,0,2,1,0,0,3
6216,0,1,1,0,1,3
6217,1,1,1,0,0,3
6218,0,0,0,3,0,3
6219,0,0,0,3,0,3
6220,1,0,0,2,0,3
6221,0,0,0,3,0,3
6222,1,0,0,1,1,3
6223,1,0,0,2,0,3
6224,0,0,0,3,0,3
6225,1,0,0,1,1,3
6226,1,1,0,1,0,3
6227,0,0,0,3,0,3
6228,0,0,0,3,0,3
6229,1,0,0,1,1,3
6230,1,0,0,2,0,3
6231,1,0,0,2,0,3
6232,1,0,0,2,0,3
6233,0,0,0,3,0,3
6234,1,0,0,2,0,3
6235,1,0,0,2,0,3
6236,1,0,0,2,0,3
6237,0,0,0,3,0,3
6238,0,1,1,1,0,3
6239,1,0,0,2,0,3
6240,1,0,0,1,1,3
6241,0,0,0,3,0,3
6242,1,0,0,1,1,3
6243,1,0,0,1,1,3
6244,1,0,0,1,1,3
6245,1,0,0,1,1,3
6246,1,0,0,1,1,3
6247,1,0,0,1,1,3
6248,1,1,0,1,0,3
6249,1,0,0,2,0,3
6250,1,0,0,1,1,3
6251,0,0,0,3,0,3
6252,1,0,0,1,1,3
6253,1,0,1,1,0,3
6254,1,0,0,1,1,3
6255,1,0,0,2,0,3
6256,0,1,1,1,0,3
6257,0,1,1,0,1,3
6258,0,0,0,0,3,3
6259,0,0,0,0,3,3
6260,0,0,0,0,3,3
6261,0,1,1,0,1,3
6262,0,1,1,0,1,3
6263,1,0,0,0,2,3
6264,0,1,1,0,1,3
6265,0,0,0,0,3,3
6266,0,1,1,0,1,3
6267,0,0,0,0,3,3
6268,0,0,0,0,3,3
6269,0,1,1,0,1,3
6270,0,1,1,0,1,3
6271,0,1,0,0,2,3
6272,0,0,0,0,3,3
6273,0,1,1,0,1,3
6274,0,1,1,0,1,3
6275,0,1,1,0,1,3
6276,0,1,1,0,1,3
6277,0,0,0,0,3,3
6278,0,1,1,0,1,3
6279,0,1,1,0,1,3
6280,1,0,0,0,2,3
6281,0,1,1,0,1,3
6282,0,1,1,0,1,3
6283,0,1,1,0,1,3
6284,0,1,1,0,1,3
6285,0,1,1,0,1,3
6286,1,0,1,0,1,3
6287,1,0,0,0,2,3
6288,0,1,1,0,1,3
6289,0,1,1,0,1,3
6290,0,0,0,0,3,3
6291,0,1,0,0,2,3
6292,0,1,1,0,1,3
6293,0,1,1,0,1,3
6294,0,1,1,0,1,3
6295,0,1,1,0,1,3
6296,0,1,1,0,1,3
6297,0,3,0,0,0,3
6298,0,3,0,0,0,3
6299,0,1,1,0,1,3
6300,0,1,1,0,1,3
6301,0,1,1,0,1,3
6302,0,1,1,0,1,3
6303,0,1,1,0,1,3
6304,0,1,1,0,1,3
6305,0,1,1,0,1,3
6306,0,3,0,0,0,3
6307,0,1,1,0,1,3
6308,0,1,1,0,1,3
6309,0,1,1,0,1,3
6310,0,1,1,0,1,3
6311,0,1,1,0,1,3
6312,0,3,0,0,0,3
6313,0,1,1,0,1,3
6314,0,1,1,0,1,3
6315,0,2,0,0,1,3
6316,0,3,0,0,0,3
6317,0,1,1,0,1,3
6318,0,1,1,0,1,3
6319,0,1,1,0,1,3
6320,0,1,1,0,1,3
6321,0,1,1,0,1,3
6322,0,1,1,0,1,3
6323,0,3,0,0,0,3
6324,0,3,0,0,0,3
6325,0,1,0,0,2,3
6326,0,1,1,0,1,3
6327,0,2,1,0,0,3
6328,0,1,1,0,1,3
6329,0,1,1,0,1,3
6330,0,1,1,0,1,3
6331,0,3,0,0,0,3
6332,0,1,1,0,1,3
6333,0,1,1,0,1,3
6334,0,1,1,0,1,3
6335,0,1,1,0,1,3
6336,0,1,1,1,0,3
6337,0,3,0,0,0,3
6338,0,1,1,0,1,3
6339,0,1,1,0,1,3
6340,0,3,0,0,0,3
6341,0,1,1,0,1,3
6342,0,1,1,0,1,3
6343,0,1,1,0,1,3
6344,0,1,1,0,1,3
6345,0,3,0,0,0,3
6346,0,1,1,0,1,3
6347,0,1,1,0,1,3
6348,0,1,1,0,1,3
6349,0,1,1,0,1,3
6350,0,1,1,0,1,3
6351,0,1,1,0,1,3
6352,0,2,1,0,0,3
6353,0,2,1,0,0,3
6354,0,2,1,0,0,3
6355,0,1,1,0,1,3
6356,0,1,1,0,1,3
6357,0,1,1,0,1,3
6358,0,2,1,0,0,3
6359,0,1,1,0,1,3
6360,0,1,1,0,1,3
6361,0,1,1,0,1,3
6362,0,2,1,0,0,3
6363,0,1,1,0,1,3
6364,0,1,1,0,1,3
6365,0,1,1,0,1,3
6366,0,2,1,0,0,3
6367,0,3,0,0,0,3
6368,0,2,1,0,0,3
6369,0,1,1,0,1,3
6370,0,1,1,0,1,3
6371,0,1,1,0,1,3
6372,0,1,1,0,1,3
6373,0,1,2,0,0,3
6374,0,1,1,0,1,3
6375,0,3,0,0,0,3
6376,0,1,1,0,1,3
6377,0,2,1,0,0,3
6378,0,3,0,0,0,3
6379,0,2,1,0,0,3
6380,0,2,1,0,0,3
6381,0,3,0,0,0,3
6382,0,1,2,0,0,3
6383,0,1,1,0,1,3
6384,0,1,1,0,1,3
6385,0,1,1,0,1,3
6386,0,1,1,0,1,3
6387,0,2,1,0,0,3
6388,0,2,1,0,0,3
6389,0,1,1,0,1,3
6390,0,1,1,0,1,3
6391,0,1,1,0,1,3
6392,0,3,0,0,0,3
6393,0,1,1,0,1,3
6394,0,1,1,0,1,3
6395,0,1,1,0,1,3
6396,0,3,0,0,0,3
6397,0,1,1,0,1,3
6398,0,1,1,0,1,3
6399,0,3,0,0,0,3
6400,0,1,1,0,1,3
6401,0,1,1,0,1,3
6402,0,3,0,0,0,3
6403,0,1,1,0,1,3
6404,0,1,1,0,1,3
6405,0,1,1,0,1,3
6406,0,1,1,0,1,3
6407,0,1,1,0,1,3
6408,0,1,1,0,1,3
6409,0,2,1,0,0,3
6410,0,1,1,0,1,3
6411,0,1,1,0,1,3
6412,0,1,1,0,1,3
6413,0,2,1,0,0,3
6414,0,1,1,0,1,3
6415,0,2,1,0,0,3
6416,0,1,1,0,1,3
6417,0,1,2,0,0,3
6418,0,1,1,0,1,3
6419,0,1,1,0,1,3
6420,0,3,0,0,0,3
6421,0,1,1,1,0,3
6422,0,1,1,0,1,3
6423,0,3,0,0,0,3
6424,0,1,1,0,1,3
6425,0,1,1,0,1,3
6426,0,1,1,0,1,3
6427,0,1,1,1,0,3
6428,0,3,0,0,0,3
6429,0,3,0,0,0,3
6430,0,1,1,0,1,3
6431,0,1,1,0,1,3
6432,0,1,1,0,1,3
6433,0,1,1,0,1,3
6434,0,2,1,0,0,3
6435,0,1,1,0,1,3
6436,0,1,1,0,1,3
6437,0,2,1,0,0,3
6438,0,1,1,0,1,3
6439,0,2,1,0,0,3
6440,0,3,0,0,0,3
6441,0,2,1,0,0,3
6442,0,2,1,0,0,3
6443,0,1,1,0,1,3
6444,0,1,1,0,1,3
6445,0,3,0,0,0,3
6446,0,2,1,0,0,3
6447,0,2,1,0,0,3
6448,0,2,1,0,0,3
6449,0,2,1,0,0,3
6450,0,3,0,0,0,3
6451,0,2,1,0,0,3
6452,0,1,1,0,1,3
6453,0,3,0,0,0,3
6454,0,1,1,0,1,3
6455,0,1,1,0,1,3
6456,0,2,1,0,0,3
6457,0,2,1,0,0,3
6458,0,2,1,0,0,3
6459,0,2,1,0,0,3
6460,0,2,1,0,0,3
6461,0,2,1,0,0,3
6462,0,2,1,0,0,3
6463,0,2,1,0,0,3
6464,0,2,1,0,0,3
6465,0,2,1,0,0,3
6466,0,2,1,0,0,3
6467,0,2,1,0,0,3
6468,0,3,0,0,0,3
6469,0,2,1,0,0,3
6470,0,1,1,0,1,3
6471,0,1,1,0,1,3
6472,0,1,1,0,1,3
6473,0,1,1,0,1,3
6474,0,1,1,0,1,3
6475,0,1,1,0,1,3
6476,0,1,1,0,1,3
6477,0,1,1,0,1,3
6478,0,1,1,0,1,3
6479,0,1,1,0,1,3
6480,0,1,1,0,1,3
6481,0,1,1,0,1,3
6482,0,1,1,0,1,3
6483,0,0,2,0,1,3
6484,0,1,1,0,1,3
6485,0,1,1,0,1,3
6486,0,1,1,0,1,3
6487,0,1,1,0,1,3
6488,0,2,1,0,0,3
6489,0,0,3,0,0,3
6490,0,1,1,0,1,3
6491,0,1,1,0,1,3
6492,0,1,1,0,1,3
6493,0,2,1,0,0,3
6494,0,1,1,1,0,3
6495,0,2,1,0,0,3
6496,0,1,1,0,1,3
6497,0,1,1,0,1,3
6498,0,1,1,0,1,3
6499,0,1,1,0,1,3
6500,0,1,1,0,1,3
6501,0,1,1,0,1,3
6502,0,1,1,0,1,3
6503,0,1,1,0,1,3
6504,0,1,1,0,1,3
6505,0,1,1,0,1,3
6506,0,1,1,0,1,3
6507,0,1,1,1,0,3
6508,0,1,1,0,1,3
6509,0,1,1,0,1,3
6510,0,1,1,0,1,3
6511,0,1,1,0,1,3
6512,0,1,1,0,1,3
6513,0,1,2,0,0,3
6514,0,0,3,0,0,3
6515,0,1,1,0,1,3
6516,0,1,1,0,1,3
6517,0,1,1,0,1,3
6518,0,1,1,0,1,3
6519,0,1,1,0,1,3
6520,0,1,2,0,0,3
6521,0,1,1,1,0,3
6522,0,1,1,0,1,3
6523,0,1,1,0,1,3
6524,0,1,1,0,1,3
6525,0,1,1,0,1,3
6526,0,1,1,0,1,3
6527,0,1,1,0,1,3
6528,0,1,1,1,0,3
6529,0,1,1,0,1,3
6530,0,1,1,0,1,3
6531,0,1,1,0,1,3
6532,0,1,1,0,1,3
6533,0,1,1,0,1,3
6534,0,1,1,0,1,3
6535,0,1,1,0,1,3
6536,0,1,1,0,1,3
6537,0,0,1,1,1,3
6538,0,1,2,0,0,3
6539,0,1,1,0,1,3
6540,0,1,1,0,1,3
6541,0,1,1,0,1,3
6542,0,1,1,0,1,3
6543,0,1,1,0,1,3
6544,0,1,1,0,1,3
6545,0,1,2,0,0,3
6546,0,1,1,0,1,3
6547,0,2,1,0,0,3
6548,0,1,1,0,1,3
6549,0,1,1,0,1,3
6550,0,1,1,1,0,3
6551,0,1,1,0,1,3
6552,0,1,1,0,1,3
6553,0,0,3,0,0,3
6554,0,1,1,0,1,3
6555,0,1,1,0,1,3
6556,0,1,1,0,1,3
6557,0,1,1,1,0,3
6558,0,1,1,0,1,3
6559,0,1,1,0,1,3
6560,0,1,1,0,1,3
6561,0,1,2,0,0,3
6562,0,1,1,0,1,3
6563,0,1,1,0,1,3
6564,0,1,1,0,1,3
6565,0,1,1,0,1,3
6566,0,1,1,0,1,3
6567,0,1,1,0,1,3
6568,0,1,1,0,1,3
6569,0,1,1,0,1,3
6570,0,1,1,0,1,3
6571,0,1,1,0,1,3
6572,0,1,1,0,1,3
6573,0,1,1,0,1,3
6574,0,1,1,0,1,3
6575,0,1,1,0,1,3
6576,0,1,1,0,1,3
6577,0,1,2,0,0,3
6578,0,1,1,0,1,3
6579,0,1,1,1,0,3
6580,0,1,1,0,1,3
6581,0,1,1,0,1,3
6582,0,1,1,0,1,3
6583,0,1,1,0,1,3
6584,0,1,1,0,1,3
6585,0,1,1,0,1,3
6586,0,1,2,0,0,3
6587,0,1,1,0,1,3
6588,0,1,1,0,1,3
6589,0,1,1,0,1,3
6590,0,1,1,0,1,3
6591,0,1,1,0,1,3
6592,0,1,1,0,1,3
6593,0,1,1,0,1,3
6594,0,1,1,0,1,3
6595,0,1,1,0,1,3
6596,0,1,1,0,1,3
6597,0,2,1,0,0,3
6598,0,1,1,0,1,3
6599,0,1,1,0,1,3
6600,0,1,1,0,1,3
6601,0,1,0,1,1,3
6602,0,1,1,0,1,3
6603,0,0,3,0,0,3
6604,0,1,1,0,1,3
6605,0,1,1,0,1,3
6606,0,1,1,0,1,3
6607,0,1,1,0,1,3
6608,0,1,1,0,1,3
6609,0,1,1,0,1,3
6610,0,1,1,0,1,3
6611,0,1,1,0,1,3
6612,0,1,1,0,1,3
6613,0,1,1,0,1,3
6614,0,1,1,0,1,3
6615,0,1,1,1,0,3
6616,0,1,1,0,1,3
6617,0,1,1,0,1,3
6618,0,1,1,0,1,3
6619,0,1,1,0,1,3
6620,0,1,1,0,1,3
6621,0,1,1,0,1,3
6622,0,1,1,0,1,3
6623,0,1,1,0,1,3
6624,0,1,1,0,1,3
6625,0,1,1,0,1,3
6626,0,1,1,0,1,3
6627,0,1,1,0,1,3
6628,0,1,1,0,1,3
6629,0,1,1,0,1,3
6630,0,1,1,0,1,3
6631,0,1,1,1,0,3
6632,0,1,1,0,1,3
6633,0,1,1,0,1,3
6634,0,1,1,0,1,3
6635,0,1,1,0,1,3
6636,0,1,1,0,1,3
6637,0,1,1,0,1,3
6638,0,1,1,0,1,3
6639,0,1,1,0,1,3
6640,0,1,1,0,1,3
6641,0,1,1,0,1,3
6642,0,1,1,0,1,3
6643,0,1,1,0,1,3
6644,0,1,1,0,1,3
6645,0,1,1,0,1,3
6646,0,2,1,0,0,3
6647,0,1,2,0,0,3
6648,0,1,1,0,1,3
6649,0,1,1,0,1,3
6650,0,1,1,0,1,3
6651,0,1,1,0,1,3
6652,0,1,1,0,1,3
6653,0,1,1,0,1,3
6654,0,1,1,0,1,3
6655,0,1,2,0,0,3
6656,0,1,1,0,1,3
6657,0,1,2,0,0,3
6658,0,1,1,0,1,3
6659,0,1,1,0,1,3
6660,0,1,1,0,1,3
6661,0,1,1,0,1,3
6662,0,1,1,0,1,3
6663,0,1,1,0,1,3
6664,0,1,1,1,0,3
6665,0,1,1,0,1,3
6666,0,0,3,0,0,3
6667,0,1,1,0,1,3
6668,0,1,1,0,1,3
6669,0,1,1,0,1,3
6670,0,1,1,0,1,3
6671,0,1,1,0,1,3
6672,0,1,1,0,1,3
6673,0,2,1,0,0,3
6674,0,1,1,0,1,3
6675,0,1,1,0,1,3
6676,0,1,1,0,1,3
6677,0,1,1,0,1,3
6678,0,1,1,0,1,3
6679,0,1,1,0,1,3
6680,0,1,1,0,1,3
6681,0,1,1,0,1,3
6682,0,1,1,0,1,3
6683,0,1,1,0,1,3
6684,0,1,1,0,1,3
6685,0,1,1,0,1,3
6686,0,1,2,0,0,3
6687,0,1,1,0,1,3
6688,0,1,1,0,1,3
6689,0,1,1,1,0,3
6690,0,1,1,0,1,3
6691,0,1,1,0,1,3
6692,0,1,1,0,1,3
6693,0,1,1,0,1,3
6694,0,1,1,0,1,3
6695,0,1,1,0,1,3
6696,0,1,1,0,1,3
6697,0,1,1,0,1,3
6698,0,1,1,0,1,3
6699,0,1,1,0,1,3
6700,0,1,1,0,1,3
6701,0,1,1,0,1,3
6702,0,1,1,0,1,3
6703,0,1,1,0,1,3
6704,0,1,1,0,1,3
6705,0,1,1,0,1,3
6706,0,1,1,0,1,3
6707,0,1,1,0,1,3
6708,0,1,2,0,0,3
6709,0,1,1,0,1,3
6710,0,1,1,0,1,3
6711,0,1,1,0,1,3
6712,0,1,1,0,1,3
6713,0,1,1,0,1,3
6714,0,1,1,0,1,3
6715,0,1,1,1,0,3
6716,0,1,1,0,1,3
6717,0,1,1,0,1,3
6718,0,2,1,0,0,3
6719,0,1,1,0,1,3
6720,0,1,1,0,1,3
6721,0,1,1,0,1,3
6722,0,1,1,0,1,3
6723,0,1,1,0,1,3
6724,0,1,1,0,1,3
6725,0,1,1,0,1,3
6726,0,1,1,0,1,3
6727,0,1,1,0,1,3
6728,0,1,1,0,1,3
6729,0,1,1,0,1,3
6730,0,1,1,0,1,3
6731,0,2,1,0,0,3
6732,0,1,1,0,1,3
6733,0,1,1,0,1,3
6734,0,1,1,0,1,3
6735,0,1,1,0,1,3
6736,0,1,1,0,1,3
6737,0,1,1,0,1,3
6738,0,1,1,0,1,3
6739,0,1,1,0,1,3
6740,0,1,1,0,1,3
6741,0,1,1,0,1,3
6742,0,1,1,0,1,3
6743,0,1,1,0,1,3
6744,0,1,1,0,1,3
6745,0,1,1,0,1,3
6746,0,1,1,0,1,3
6747,0,1,1,0,1,3
6748,0,1,2,0,0,3
6749,0,1,1,0,1,3
6750,0,1,1,0,1,3
6751,0,1,1,0,1,3
6752,0,1,1,0,1,3
6753,0,1,1,0,1,3
6754,0,1,1,0,1,3
6755,0,1,1,0,1,3
6756,0,1,1,1,0,3
6757,0,1,1,0,1,3
6758,0,1,1,0,1,3
6759,0,1,1,0,1,3
6760,0,1,1,0,1,3
6761,0,1,1,0,1,3
6762,0,1,1,0,1,3
6763,0,1,1,0,1,3
6764,0,1,1,0,1,3
6765,0,1,1,0,1,3
6766,0,1,1,0,1,3
6767,0,1,1,0,1,3
6768,0,1,1,0,1,3
6769,0,1,1,0,1,3
6770,0,1,1,0,1,3
6771,0,1,1,0,1,3
6772,0,2,1,0,0,3
6773,0,1,1,0,1,3
6774,0,1,1,0,1,3
6775,0,1,1,0,1,3
6776,0,1,1,0,1,3
6777,0,1,1,0,1,3
6778,0,1,1,0,1,3
6779,0,1,1,0,1,3
6780,0,1,1,0,1,3
6781,0,1,1,0,1,3
6782,0,1,1,0,1,3
6783,0,1,1,0,1,3
6784,0,2,1,0,0,3
6785,0,1,1,0,1,3
6786,0,1,1,0,1,3
6787,0,1,1,0,1,3
6788,0,1,1,0,1,3
6789,0,1,1,0,1,3
6790,0,1,1,0,1,3
6791,0,1,1,0,1,3
6792,0,1,1,0,1,3
6793,0,1,1,0,1,3
6794,0,1,1,0,1,3
6795,0,1,1,0,1,3
6796,0,1,1,0,1,3
6797,0,1,1,0,1,3
6798,0,1,1,0,1,3
6799,0,1,1,0,1,3
6800,0,1,1,0,1,3
6801,0,1,1,0,1,3
6802,0,1,1,0,1,3
6803,0,1,1,0,1,3
6804,0,1,1,1,0,3
6805,0,1,1,0,1,3
6806,0,1,1,0,1,3
6807,0,1,1,0,1,3
6808,0,1,1,0,1,3
6809,0,1,1,0,1,3
6810,0,1,1,0,1,3
6811,0,0,3,0,0,3
6812,0,1,1,0,1,3
6813,0,1,1,0,1,3
6814,0,1,1,0,1,3
6815,0,1,1,0,1,3
6816,0,1,1,0,1,3
6817,0,1,1,0,1,3
6818,0,1,1,0,1,3
6819,0,1,1,0,1,3
6820,0,1,1,0,1,3
6821,0,1,1,0,1,3
6822,0,1,1,0,1,3
6823,0,2,1,0,0,3
6824,0,1,1,0,1,3
6825,0,1,1,0,1,3
6826,0,1,1,0,1,3
6827,0,1,1,0,1,3
6828,0,1,1,0,1,3
6829,0,1,1,0,1,3
6830,0,1,1,0,1,3
6831,0,1,1,0,1,3
6832,0,1,1,0,1,3
6833,0,1,1,0,1,3
6834,0,1,1,0,1,3
6835,0,1,1,0,1,3
6836,0,1,1,0,1,3
6837,0,1,1,0,1,3
6838,0,2,1,0,0,3
6839,0,1,1,0,1,3
6840,0,1,1,0,1,3
6841,0,1,1,0,1,3
6842,0,1,1,0,1,3
6843,0,1,1,0,1,3
6844,0,1,1,0,1,3
6845,0,1,2,0,0,3
6846,0,1,1,0,1,3
6847,0,1,1,0,1,3
6848,0,1,1,0,1,3
6849,0,1,1,0,1,3
6850,0,1,1,0,1,3
6851,0,1,1,0,1,3
6852,0,1,1,0,1,3
6853,0,1,1,0,1,3
6854,0,1,1,0,1,3
6855,0,0,1,1,1,3
6856,0,1,1,0,1,3
6857,0,1,1,0,1,3
6858,0,1,1,0,1,3
6859,0,1,1,0,1,3
6860,0,1,1,0,1,3
6861,0,1,1,0,1,3
6862,0,1,1,0,1,3
6863,0,2,1,0,0,3
6864,0,1,1,0,1,3
6865,0,1,1,0,1,3
6866,0,1,1,0,1,3
6867,0,2,1,0,0,3
6868,0,1,1,0,1,3
6869,0,1,1,0,1,3
6870,0,1,1,0,1,3
6871,0,1,1,0,1,3
6872,0,1,2,0,0,3
6873,0,1,1,0,1,3
6874,0,1,1,0,1,3
6875,0,1,1,0,1,3
6876,0,1,1,1,0,3
6877,0,1,1,0,1,3
6878,0,1,1,0,1,3
6879,0,1,1,0,1,3
6880,0,1,1,0,1,3
6881,0,1,1,0,1,3
6882,0,1,1,0,1,3
6883,0,1,2,0,0,3
6884,0,1,1,0,1,3
6885,0,1,1,0,1,3
6886,0,1,1,0,1,3
6887,0,1,1,0,1,3
6888,0,1,1,0,1,3
6889,0,1,2,0,0,3
6890,0,1,1,0,1,3
6891,0,0,2,1,0,3
6892,0,1,1,0,1,3
6893,0,1,1,0,1,3
6894,0,1,1,0,1,3
6895,0,1,1,0,1,3
6896,0,1,1,0,1,3
6897,0,1,1,0,1,3
6898,0,1,1,0,1,3
6899,0,1,1,0,1,3
6900,0,1,2,0,0,3
6901,0,1,1,0,1,3
6902,0,1,1,0,1,3
6903,0,1,1,0,1,3
6904,0,1,1,0,1,3
6905,0,1,1,0,1,3
6906,0,1,1,0,1,3
6907,0,1,2,0,0,3
6908,0,1,1,0,1,3
6909,0,1,1,0,1,3
6910,0,1,1,0,1,3
6911,0,1,1,0,1,3
6912,0,1,1,0,1,3
6913,0,1,1,0,1,3
6914,0,1,0,1,1,3
6915,0,1,1,0,1,3
6916,0,1,1,0,1,3
6917,0,1,1,0,1,3
6918,0,1,1,0,1,3
6919,0,1,1,0,1,3
6920,0,1,1,0,1,3
6921,0,2,1,0,0,3
6922,0,1,1,0,1,3
6923,0,1,1,0,1,3
6924,0,1,1,0,1,3
6925,0,1,1,0,1,3
6926,0,1,1,0,1,3
6927,0,1,1,1,0,3
6928,0,1,1,0,1,3
6929,0,1,1,0,1,3
6930,0,1,1,0,1,3
6931,0,1,1,0,1,3
6932,0,1,1,0,1,3
6933,0,1,1,0,1,3
6934,0,1,1,0,1,3
6935,0,1,1,0,1,3
6936,0,1,1,0,1,3
6937,0,1,1,0,1,3
6938,0,1,1,0,1,3
6939,0,2,1,0,0,3
6940,0,1,1,1,0,3
6941,0,1,1,0,1,3
6942,0,1,1,1,0,3
6943,0,1,1,0,1,3
6944,0,1,1,0,1,3
6945,0,1,1,0,1,3
6946,0,1,1,0,1,3
6947,0,1,1,0,1,3
6948,0,1,1,1,0,3
6949,0,1,1,0,1,3
6950,0,1,1,0,1,3
6951,0,1,1,0,1,3
6952,0,2,1,0,0,3
6953,0,1,1,0,1,3
6954,0,1,1,0,1,3
6955,0,1,1,0,1,3
6956,0,1,1,0,1,3
6957,0,1,1,0,1,3
6958,0,1,1,0,1,3
6959,0,1,1,1,0,3
6960,0,1,1,0,1,3
6961,0,1,1,0,1,3
6962,0,1,1,0,1,3
6963,0,1,1,0,1,3
6964,0,1,1,0,1,3
6965,0,1,1,0,1,3
6966,0,1,1,1,0,3
6967,0,1,1,0,1,3
6968,0,1,2,0,0,3
6969,0,1,1,0,1,3
6970,0,1,1,0,1,3
6971,0,1,1,0,1,3
6972,0,1,1,0,1,3
6973,0,1,1,0,1,3
6974,0,1,1,0,1,3
6975,0,1,1,0,1,3
6976,0,1,1,0,1,3
6977,0,1,1,0,1,3
6978,0,1,1,0,1,3
6979,0,1,1,0,1,3
6980,0,1,1,0,1,3
6981,0,2,1,0,0,3
6982,0,1,1,0,1,3
6983,0,1,1,1,0,3
6984,0,1,1,0,1,3
6985,0,1,1,0,1,3
6986,0,1,1,0,1,3
6987,0,1,1,0,1,3
6988,0,1,1,0,1,3
6989,0,1,1,0,1,3
6990,0,1,1,0,1,3
6991,0,1,1,0,1,3
6992,0,1,1,0,1,3
6993,0,1,1,0,1,3
6994,0,1,1,0,1,3
6995,0,2,1,0,0,3
6996,0,1,1,0,1,3
6997,0,1,1,0,1,3
6998,0,1,1,0,1,3
6999,0,1,2,0,0,3
7000,0,2,1,0,0,3
7001,0,1,1,0,1,3
7002,0,1,1,0,1,3
7003,0,1,1,0,1,3
7004,0,1,1,1,0,3
7005,0,1,1,0,1,3
7006,0,1,1,0,1,3
7007,0,1,1,0,1,3
7008,0,1,1,0,1,3
7009,0,1,1,0,1,3
7010,0,1,1,0,1,3
7011,0,1,1,0,1,3
7012,0,1,1,0,1,3
7013,0,1,1,0,1,3
7014,0,1,1,1,0,3
7015,0,1,1,0,1,3
7016,0,1,1,0,1,3
7017,0,1,1,0,1,3
7018,0,1,1,0,1,3
7019,0,1,1,1,0,3
7020,0,1,1,0,1,3
7021,0,1,1,0,1,3
7022,0,1,1,0,1,3
7023,0,1,1,0,1,3
7024,0,1,1,0,1,3
7025,0,1,1,0,1,3
7026,0,1,1,0,1,3
7027,0,1,1,0,1,3
7028,0,1,1,0,1,3
7029,0,1,1,0,1,3
7030,0,1,1,0,1,3
7031,0,1,1,0,1,3
7032,0,1,1,0,1,3
7033,0,1,1,0,1,3
7034,0,1,1,0,1,3
7035,0,1,1,0,1,3
7036,0,1,1,0,1,3
7037,0,1,1,0,1,3
7038,0,1,1,0,1,3
7039,0,1,1,0,1,3
7040,0,1,1,0,1,3
7041,0,1,1,0,1,3
7042,0,1,1,0,1,3
7043,0,1,1,0,1,3
7044,0,1,1,0,1,3
7045,0,1,1,0,1,3
7046,0,1,1,0,1,3
7047,0,1,1,0,1,3
7048,0,1,1,0,1,3
7049,0,1,1,0,1,3
7050,0,1,1,0,1,3
7051,0,1,0,0,2,3
7052,0,1,2,0,0,3
7053,0,1,1,0,1,3
7054,0,1,1,0,1,3
7055,0,1,1,0,1,3
7056,0,1,1,0,1,3
7057,0,1,2,0,0,3
7058,0,1,1,0,1,3
7059,0,1,1,0,1,3
7060,0,1,1,0,1,3
7061,0,1,1,0,1,3
7062,0,1,1,0,1,3
7063,0,1,1,0,1,3
7064,0,1,1,0,1,3
7065,0,1,1,0,1,3
7066,0,1,0,1,1,3
7067,0,1,1,0,1,3
7068,0,1,1,0,1,3
7069,0,1,1,0,1,3
7070,0,1,1,0,1,3
7071,0,1,1,0,1,3
7072,0,1,1,0,1,3
7073,0,1,1,0,1,3
7074,0,1,1,0,1,3
7075,0,1,1,0,1,3
7076,0,1,1,0,1,3
7077,0,1,1,0,1,3
7078,0,1,1,0,1,3
7079,0,1,2,0,0,3
7080,0,1,1,0,1,3
7081,0,1,1,0,1,3
7082,0,1,1,0,1,3
7083,0,1,1,0,1,3
7084,0,1,1,0,1,3
7085,0,1,1,0,1,3
7086,0,1,1,0,1,3
7087,0,1,1,0,1,3
7088,0,1,1,0,1,3
7089,0,1,1,0,1,3
7090,0,1,0,1,1,3
7091,0,1,0,1,1,3
7092,0,0,0,3,0,3
7093,0,1,0,1,1,3
7094,0,1,1,1,0,3
7095,0,1,0,1,1,3
7096,0,1,0,1,1,3
7097,0,1,0,0,2,3
7098,0,1,1,0,1,3
7099,0,0,0,0,3,3
7100,0,1,0,0,2,3
7101,0,1,0,0,2,3
7102,0,1,1,0,1,3
7103,0,1,0,0,2,3
7104,0,0,0,0,3,3
7105,0,1,0,0,2,3
7106,0,0,3,0,0,3
7107,0,0,3,0,0,3
7108,0,0,3,0,0,3
7109,0,0,3,0,0,3
7110,0,0,3,0,0,3
7111,0,0,3,0,0,3
7112,0,0,3,0,0,3
7113,0,0,3,0,0,3
7114,0,0,3,0,0,3
7115,0,0,3,0,0,3
7116,0,0,0,3,0,3
7117,0,0,1,2,0,3
7118,0,0,1,1,1,3
7119,0,0,1,1,1,3
7120,0,0,0,0,3,3
7121,0,0,1,0,2,3
7122,0,0,0,0,3,3
7123,0,0,0,0,3,3
7124,0,0,0,0,3,3
7125,0,0,0,3,0,3
7126,0,0,0,3,0,3
7127,0,0,0,2,1,3
7128,0,0,0,3,0,3
7129,0,0,0,3,0,3
7130,0,0,0,3,0,3
7131,0,0,0,3,0,3
7132,0,0,0,3,0,3
7133,0,0,0,3,0,3
7134,0,0,0,3,0,3
7135,0,0,0,0,3,3
7136,0,0,0,0,3,3
7137,0,0,0,0,3,3
7138,0,0,0,0,3,3
7139,0,0,0,0,3,3
7140,0,0,0,0,3,3
7141,0,0,0,0,3,3
7142,0,0,0,0,3,3
7143,0,0,0,0,3,3
7144,0,0,0,0,3,3
7145,0,0,0,0,3,3
7146,2,0,0,0,0,2
7147,1,0,0,1,0,2
7148,2,0,0,0,0,2
7149,2,0,0,0,0,2
7150,2,0,0,0,0,2
7151,2,0,0,0,0,2
7152,2,0,0,0,0,2
7153,2,0,0,0,0,2
7154,2,0,0,0,0,2
7155,2,0,0,0,0,2
7156,2,0,0,0,0,2
7157,1,0,0,0,1,2
7158,2,0,0,0,0,2
7159,1,0,0,1,0,2
7160,1,0,0,0,1,2
7161,2,0,0,0,0,2
7162,2,0,0,0,0,2
7163,2,0,0,0,0,2
7164,2,0,0,0,0,2
7165,2,0,0,0,0,2
7166,1,0,0,1,0,2
7167,1,0,0,1,0,2
7168,1,0,0,1,0,2
7169,2,0,0,0,0,2
7170,2,0,0,0,0,2
7171,1,0,1,0,0,2
7172,1,0,0,1,0,2
7173,2,0,0,0,0,2
7174,2,0,0,0,0,2
7175,1,0,1,0,0,2
7176,2,0,0,0,0,2
7177,2,0,0,0,0,2
7178,2,0,0,0,0,2
7179,1,1,0,0,0,2
7180,2,0,0,0,0,2
7181,2,0,0,0,0,2
7182,1,0,0,1,0,2
7183,2,0,0,0,0,2
7184,2,0,0,0,0,2
7185,2,0,0,0,0,2
7186,1,0,0,1,0,2
7187,2,0,0,0,0,2
7188,1,0,1,0,0,2
7189,1,0,0,0,1,2
7190,1,0,0,0,1,2
7191,1,0,0,1,0,2
7192,1,0,0,1,0,2
7193,2,0,0,0,0,2
7194,2,0,0,0,0,2
7195,2,0,0,0,0,2
7196,1,0,0,1,0,2
7197,2,0,0,0,0,2
7198,1,0,1,0,0,2
7199,2,0,0,0,0,2
7200,2,0,0,0,0,2
7201,2,0,0,0,0,2
7202,2,0,0,0,0,2
7203,1,0,0,1,0,2
7204,1,0,0,1,0,2
7205,1,0,0,1,0,2
7206,1,0,0,1,0,2
7207,1,0,0,1,0,2
7208,1,0,0,1,0,2
7209,1,0,0,0,1,2
7210,1,1,0,0,0,2
7211,2,0,0,0,0,2
7212,1,0,0,1,0,2
7213,1,0,0,1,0,2
7214,1,0,0,1,0,2
7215,1,1,0,0,0,2
7216,1,0,1,0,0,2
7217,2,0,0,0,0,2
7218,2,0,0,0,0,2
7219,1,0,0,1,0,2
7220,1,0,1,0,0,2
7221,1,0,1,0,0,2
7222,2,0,0,0,0,2
7223,2,0,0,0,0,2
7224,2,0,0,0,0,2
7225,1,0,1,0,0,2
7226,1,0,1,0,0,2
7227,2,0,0,0,0,2
7228,1,0,0,1,0,2
7229,2,0,0,0,0,2
7230,1,0,0,0,1,2
7231,2,0,0,0,0,2
7232,2,0,0,0,0,2
7233,2,0,0,0,0,2
7234,2,0,0,0,0,2
7235,2,0,0,0,0,2
7236,2,0,0,0,0,2
7237,2,0,0,0,0,2
7238,1,0,0,1,0,2
7239,1,0,0,1,0,2
7240,1,1,0,0,0,2
7241,1,0,0,1,0,2
7242,1,0,0,1,0,2
7243,1,0,1,0,0,2
7244,2,0,0,0,0,2
7245,2,0,0,0,0,2
7246,2,0,0,0,0,2
7247,2,0,0,0,0,2
7248,1,0,0,1,0,2
7249,2,0,0,0,0,2
7250,2,0,0,0,0,2
7251,2,0,0,0,0,2
7252,2,0,0,0,0,2
7253,2,0,0,0,0,2
7254,2,0,0,0,0,2
7255,2,0,0,0,0,2
7256,2,0,0,0,0,2
7257,2,0,0,0,0,2
7258,2,0,0,0,0,2
7259,2,0,0,0,0,2
7260,1,0,0,1,0,2
7261,2,0,0,0,0,2
7262,2,0,0,0,0,2
7263,2,0,0,0,0,2
7264,2,0,0,0,0,2
7265,1,0,0,1,0,2
7266,2,0,0,0,0,2
7267,2,0,0,0,0,2
7268,2,0,0,0,0,2
7269,2,0,0,0,0,2
7270,1,0,1,0,0,2
7271,2,0,0,0,0,2
7272,2,0,0,0,0,2
7273,2,0,0,0,0,2
7274,2,0,0,0,0,2
7275,2,0,0,0,0,2
7276,2,0,0,0,0,2
7277,2,0,0,0,0,2
7278,2,0,0,0,0,2
7279,2,0,0,0,0,2
7280,2,0,0,0,0,2
7281,2,0,0,0,0,2
7282,2,0,0,0,0,2
7283,2,0,0,0,0,2
7284,2,0,0,0,0,2
7285,2,0,0,0,0,2
7286,2,0,0,0,0,2
7287,2,0,0,0,0,2
7288,2,0,0,0,0,2
7289,2,0,0,0,0,2
7290,1,0,1,0,0,2
7291,2,0,0,0,0,2
7292,2,0,0,0,0,2
7293,2,0,0,0,0,2
7294,2,0,0,0,0,2
7295,2,0,0,0,0,2
7296,2,0,0,0,0,2
7297,2,0,0,0,0,2
7298,2,0,0,0,0,2
7299,2,0,0,0,0,2
7300,1,1,0,0,0,2
7301,2,0,0,0,0,2
7302,2,0,0,0,0,2
7303,1,0,0,1,0,2
7304,2,0,0,0,0,2
7305,1,0,0,1,0,2
7306,1,0,0,1,0,2
7307,2,0,0,0,0,2
7308,1,0,0,0,1,2
7309,1,0,1,0,0,2
7310,2,0,0,0,0,2
7311,2,0,0,0,0,2
7312,1,0,0,1,0,2
7313,1,0,0,0,1,2
7314,1,1,0,0,0,2
7315,2,0,0,0,0,2
7316,2,0,0,0,0,2
7317,1,0,0,1,0,2
7318,1,0,0,1,0,2
7319,2,0,0,0,0,2
7320,2,0,0,0,0,2
7321,2,0,0,0,0,2
7322,2,0,0,0,0,2
7323,2,0,0,0,0,2
7324,1,0,0,1,0,2
7325,2,0,0,0,0,2
7326,1,0,0,1,0,2
7327,1,0,0,1,0,2
7328,2,0,0,0,0,2
7329,2,0,0,0,0,2
7330,2,0,0,0,0,2
7331,2,0,0,0,0,2
7332,2,0,0,0,0,2
7333,2,0,0,0,0,2
7334,1,0,0,1,0,2
7335,2,0,0,0,0,2
7336,2,0,0,0,0,2
7337,2,0,0,0,0,2
7338,2,0,0,0,0,2
7339,2,0,0,0,0,2
7340,2,0,0,0,0,2
7341,2,0,0,0,0,2
7342,2,0,0,0,0,2
7343,2,0,0,0,0,2
7344,2,0,0,0,0,2
7345,2,0,0,0,0,2
7346,1,0,0,0,1,2
7347,1,0,0,1,0,2
7348,2,0,0,0,0,2
7349,2,0,0,0,0,2
7350,2,0,0,0,0,2
7351,1,0,0,1,0,2
7352,2,0,0,0,0,2
7353,2,0,0,0,0,2
7354,2,0,0,0,0,2
7355,1,0,0,1,0,2
7356,2,0,0,0,0,2
7357,2,0,0,0,0,2
7358,1,0,0,1,0,2
7359,2,0,0,0,0,2
7360,2,0,0,0,0,2
7361,2,0,0,0,0,2
7362,2,0,0,0,0,2
7363,2,0,0,0,0,2
7364,2,0,0,0,0,2
7365,2,0,0,0,0,2
7366,2,0,0,0,0,2
7367,2,0,0,0,0,2
7368,2,0,0,0,0,2
7369,2,0,0,0,0,2
7370,1,0,0,1,0,2
7371,2,0,0,0,0,2
7372,1,0,0,1,0,2
7373,1,0,0,1,0,2
7374,2,0,0,0,0,2
7375,2,0,0,0,0,2
7376,1,0,0,1,0,2
7377,2,0,0,0,0,2
7378,2,0,0,0,0,2
7379,2,0,0,0,0,2
7380,1,1,0,0,0,2
7381,2,0,0,0,0,2
7382,2,0,0,0,0,2
7383,2,0,0,0,0,2
7384,2,0,0,0,0,2
7385,1,0,0,1,0,2
7386,2,0,0,0,0,2
7387,2,0,0,0,0,2
7388,2,0,0,0,0,2
7389,2,0,0,0,0,2
7390,2,0,0,0,0,2
7391,2,0,0,0,0,2
7392,2,0,0,0,0,2
7393,2,0,0,0,0,2
7394,1,0,0,0,1,2
7395,2,0,0,0,0,2
7396,2,0,0,0,0,2
7397,2,0,0,0,0,2
7398,2,0,0,0,0,2
7399,2,0,0,0,0,2
7400,2,0,0,0,0,2
7401,0,1,0,0,1,2
7402,0,1,1,0,0,2
7403,1,0,0,1,0,2
7404,0,1,1,0,0,2
7405,0,1,1,0,0,2
7406,0,1,1,0,0,2
7407,1,0,0,1,0,2
7408,0,1,1,0,0,2
7409,0,1,1,0,0,2
7410,0,2,0,0,0,2
7411,0,1,1,0,0,2
7412,0,1,1,0,0,2
7413,1,1,0,0,0,2
7414,1,0,0,1,0,2
7415,0,1,1,0,0,2
7416,0,1,1,0,0,2
7417,0,1,1,0,0,2
7418,0,1,1,0,0,2
7419,0,1,1,0,0,2
7420,0,1,1,0,0,2
7421,0,1,1,0,0,2
7422,0,1,1,0,0,2
7423,0,1,1,0,0,2
7424,0,1,1,0,0,2
7425,0,1,1,0,0,2
7426,0,1,1,0,0,2
7427,0,1,1,0,0,2
7428,0,1,1,0,0,2
7429,0,1,1,0,0,2
7430,0,1,1,0,0,2
7431,0,1,1,0,0,2
7432,0,1,1,0,0,2
7433,0,1,1,0,0,2
7434,1,0,0,0,1,2
7435,0,1,1,0,0,2
7436,0,1,0,0,1,2
7437,1,1,0,0,0,2
7438,1,1,0,0,0,2
7439,0,1,1,0,0,2
7440,1,1,0,0,0,2
7441,0,1,1,0,0,2
7442,0,1,0,0,1,2
7443,1,0,0,1,0,2
7444,0,1,1,0,0,2
7445,0,1,1,0,0,2
7446,0,1,1,0,0,2
7447,0,1,1,0,0,2
7448,1,0,0,1,0,2
7449,0,1,1,0,0,2
7450,0,1,1,0,0,2
7451,1,1,0,0,0,2
7452,0,1,1,0,0,2
7453,0,1,1,0,0,2
7454,1,1,0,0,0,2
7455,0,1,1,0,0,2
7456,1,0,0,1,0,2
7457,0,1,1,0,0,2
7458,0,1,1,0,0,2
7459,0,1,1,0,0,2
7460,0,1,1,0,0,2
7461,0,1,1,0,0,2
7462,0,1,1,0,0,2
7463,0,1,0,0,1,2
7464,1,0,0,1,0,2
7465,1,0,0,1,0,2
7466,0,1,0,0,1,2
7467,0,1,1,0,0,2
7468,0,1,1,0,0,2
7469,0,2,0,0,0,2
7470,0,1,1,0,0,2
7471,0,1,1,0,0,2
7472,0,1,1,0,0,2
7473,0,1,1,0,0,2
7474,0,1,1,0,0,2
7475,1,1,0,0,0,2
7476,0,1,1,0,0,2
7477,0,1,1,0,0,2
7478,1,0,1,0,0,2
7479,0,1,1,0,0,2
7480,1,1,0,0,0,2
7481,0,1,1,0,0,2
7482,0,1,1,0,0,2
7483,0,1,1,0,0,2
7484,1,1,0,0,0,2
7485,0,1,1,0,0,2
7486,0,1,1,0,0,2
7487,0,1,1,0,0,2
7488,0,1,1,0,0,2
7489,1,1,0,0,0,2
7490,0,1,0,0,1,2
7491,0,1,1,0,0,2
7492,0,1,1,0,0,2
7493,0,1,1,0,0,2
7494,0,1,1,0,0,2
7495,0,1,1,0,0,2
7496,0,1,1,0,0,2
7497,0,1,0,0,1,2
7498,0,1,1,0,0,2
7499,0,1,1,0,0,2
7500,0,1,1,0,0,2
7501,0,1,1,0,0,2
7502,0,1,1,0,0,2
7503,0,1,1,0,0,2
7504,0,1,1,0,0,2
7505,0,1,1,0,0,2
7506,0,1,1,0,0,2
7507,0,1,1,0,0,2
7508,0,1,1,0,0,2
7509,0,1,1,0,0,2
7510,0,1,1,0,0,2
7511,0,1,1,0,0,2
7512,0,1,1,0,0,2
7513,0,1,1,0,0,2
7514,1,0,0,1,0,2
7515,0,1,0,0,1,2
7516,0,1,1,0,0,2
7517,0,1,1,0,0,2
7518,1,1,0,0,0,2
7519,0,1,1,0,0,2
7520,0,1,1,0,0,2
7521,0,1,1,0,0,2
7522,0,1,1,0,0,2
7523,1,0,0,1,0,2
7524,0,1,1,0,0,2
7525,0,1,1,0,0,2
7526,1,0,0,0,1,2
7527,1,1,0,0,0,2
7528,1,1,0,0,0,2
7529,1,0,0,1,0,2
7530,0,1,1,0,0,2
7531,0,1,1,0,0,2
7532,0,1,1,0,0,2
7533,0,1,0,0,1,2
7534,0,1,1,0,0,2
7535,0,1,1,0,0,2
7536,1,0,0,1,0,2
7537,1,0,0,0,1,2
7538,0,1,1,0,0,2
7539,0,1,1,0,0,2
7540,1,0,0,1,0,2
7541,0,1,1,0,0,2
7542,0,1,1,0,0,2
7543,1,1,0,0,0,2
7544,0,1,1,0,0,2
7545,1,1,0,0,0,2
7546,1,1,0,0,0,2
7547,1,1,0,0,0,2
7548,1,1,0,0,0,2
7549,1,1,0,0,0,2
7550,1,1,0,0,0,2
7551,0,1,1,0,0,2
7552,1,0,0,1,0,2
7553,0,1,1,0,0,2
7554,0,1,1,0,0,2
7555,0,1,1,0,0,2
7556,0,1,1,0,0,2
7557,0,1,0,0,1,2
7558,1,0,0,1,0,2
7559,0,1,1,0,0,2
7560,0,1,1,0,0,2
7561,0,1,1,0,0,2
7562,0,1,1,0,0,2
7563,0,1,1,0,0,2
7564,0,1,1,0,0,2
7565,0,1,1,0,0,2
7566,1,0,0,1,0,2
7567,0,1,0,0,1,2
7568,0,1,1,0,0,2
7569,0,1,0,0,1,2
7570,0,1,1,0,0,2
7571,1,0,0,1,0,2
7572,0,1,1,0,0,2
7573,0,1,1,0,0,2
7574,1,1,0,0,0,2
7575,0,1,1,0,0,2
7576,0,1,1,0,0,2
7577,0,1,1,0,0,2
7578,0,1,1,0,0,2
7579,1,1,0,0,0,2
7580,0,1,1,0,0,2
7581,0,1,1,0,0,2
7582,1,1,0,0,0,2
7583,0,1,1,0,0,2
7584,1,1,0,0,0,2
7585,1,0,1,0,0,2
7586,0,1,1,0,0,2
7587,0,1,1,0,0,2
7588,0,1,1,0,0,2
7589,0,1,1,0,0,2
7590,1,1,0,0,0,2
7591,0,1,1,0,0,2
7592,1,0,0,1,0,2
7593,0,1,1,0,0,2
7594,0,1,1,0,0,2
7595,1,1,0,0,0,2
7596,0,2,0,0,0,2
7597,0,1,1,0,0,2
7598,0,1,1,0,0,2
7599,0,1,1,0,0,2
7600,0,1,1,0,0,2
7601,0,1,1,0,0,2
7602,0,1,1,0,0,2
7603,0,1,1,0,0,2
7604,0,1,1,0,0,2
7605,1,0,0,0,1,2
7606,0,1,1,0,0,2
7607,1,1,0,0,0,2
7608,0,1,1,0,0,2
7609,0,1,1,0,0,2
7610,0,1,1,0,0,2
7611,0,1,1,0,0,2
7612,0,1,0,0,1,2
7613,0,1,1,0,0,2
7614,0,1,1,0,0,2
7615,0,1,1,0,0,2
7616,0,1,1,0,0,2
7617,0,1,1,0,0,2
7618,0,1,1,0,0,2
7619,0,1,1,0,0,2
7620,0,1,1,0,0,2
7621,0,1,0,0,1,2
7622,0,1,1,0,0,2
7623,0,1,1,0,0,2
7624,0,1,1,0,0,2
7625,0,1,1,0,0,2
7626,0,1,1,0,0,2
7627,0,1,1,0,0,2
7628,0,1,1,0,0,2
7629,0,1,1,0,0,2
7630,0,1,1,0,0,2
7631,0,1,1,0,0,2
7632,0,1,1,0,0,2
7633,0,1,1,0,0,2
7634,0,1,1,0,0,2
7635,1,1,0,0,0,2
7636,0,1,1,0,0,2
7637,0,1,1,0,0,2
7638,0,1,1,0,0,2
7639,1,0,0,1,0,2
7640,1,0,1,0,0,2
7641,0,1,1,0,0,2
7642,0,1,1,0,0,2
7643,0,1,1,0,0,2
7644,0,1,1,0,0,2
7645,0,1,1,0,0,2
7646,1,1,0,0,0,2
7647,0,1,0,0,1,2
7648,0,1,1,0,0,2
7649,0,2,0,0,0,2
7650,0,1,1,0,0,2
7651,0,1,1,0,0,2
7652,0,1,1,0,0,2
7653,0,1,1,0,0,2
7654,0,1,1,0,0,2
7655,0,1,1,0,0,2
7656,0,1,1,0,0,2
7657,0,1,1,0,0,2
7658,0,1,0,0,1,2
7659,0,1,1,0,0,2
7660,1,1,0,0,0,2
7661,0,1,1,0,0,2
7662,1,0,0,1,0,2
7663,0,1,1,0,0,2
7664,0,1,1,0,0,2
7665,0,1,1,0,0,2
7666,1,0,0,1,0,2
7667,0,1,1,0,0,2
7668,0,1,1,0,0,2
7669,0,1,0,0,1,2
7670,1,1,0,0,0,2
7671,1,1,0,0,0,2
7672,0,1,1,0,0,2
7673,0,1,1,0,0,2
7674,0,1,1,0,0,2
7675,1,1,0,0,0,2
7676,1,1,0,0,0,2
7677,0,1,1,0,0,2
7678,0,1,1,0,0,2
7679,0,1,1,0,0,2
7680,0,1,1,0,0,2
7681,0,1,1,0,0,2
7682,0,1,1,0,0,2
7683,0,1,1,0,0,2
7684,0,1,1,0,0,2
7685,0,1,1,0,0,2
7686,0,1,1,0,0,2
7687,0,1,1,0,0,2
7688,0,1,1,0,0,2
7689,0,1,1,0,0,2
7690,1,0,0,1,0,2
7691,0,1,1,0,0,2
7692,0,1,1,0,0,2
7693,0,1,0,1,0,2
7694,0,1,1,0,0,2
7695,0,1,1,0,0,2
7696,0,1,1,0,0,2
7697,0,1,0,0,1,2
7698,1,0,0,0,1,2
7699,1,1,0,0,0,2
7700,1,0,0,1,0,2
7701,0,1,1,0,0,2
7702,0,1,1,0,0,2
7703,0,1,1,0,0,2
7704,0,1,1,0,0,2
7705,1,0,0,1,0,2
7706,0,1,0,0,1,2
7707,1,1,0,0,0,2
7708,0,1,1,0,0,2
7709,0,1,1,0,0,2
7710,1,1,0,0,0,2
7711,0,1,1,0,0,2
7712,0,1,1,0,0,2
7713,1,0,1,0,0,2
7714,0,1,1,0,0,2
7715,0,0,1,0,1,2
7716,0,0,1,0,1,2
7717,0,0,1,0,1,2
7718,1,0,1,0,0,2
7719,0,1,1,0,0,2
7720,0,0,1,0,1,2
7721,0,0,2,0,0,2
7722,0,0,1,1,0,2
7723,0,0,1,0,1,2
7724,1,0,1,0,0,2
7725,0,1,1,0,0,2
7726,0,1,1,0,0,2
7727,0,1,1,0,0,2
7728,0,1,1,0,0,2
7729,1,0,1,0,0,2
7730,0,0,1,0,1,2
7731,1,0,1,0,0,2
7732,0,1,1,0,0,2
7733,0,1,1,0,0,2
7734,1,0,0,1,0,2
7735,0,1,1,0,0,2
7736,0,0,1,0,1,2
7737,0,1,1,0,0,2
7738,1,0,0,1,0,2
7739,0,1,1,0,0,2
7740,0,1,1,0,0,2
7741,0,1,1,0,0,2
7742,0,1,1,0,0,2
7743,0,1,1,0,0,2
7744,1,0,0,1,0,2
7745,0,1,1,0,0,2
7746,0,1,1,0,0,2
7747,0,1,1,0,0,2
7748,0,1,1,0,0,2
7749,0,1,1,0,0,2
7750,0,0,2,0,0,2
7751,0,0,2,0,0,2
7752,0,1,1,0,0,2
7753,1,0,1,0,0,2
7754,0,1,1,0,0,2
7755,0,0,1,0,1,2
7756,0,0,2,0,0,2
7757,0,1,1,0,0,2
7758,0,1,1,0,0,2
7759,1,0,1,0,0,2
7760,1,0,1,0,0,2
7761,0,1,1,0,0,2
7762,0,0,2,0,0,2
7763,0,1,1,0,0,2
7764,0,1,1,0,0,2
7765,0,1,1,0,0,2
7766,0,0,2,0,0,2
7767,0,0,2,0,0,2
7768,1,0,0,1,0,2
7769,1,0,0,1,0,2
7770,0,1,1,0,0,2
7771,1,0,1,0,0,2
7772,0,0,2,0,0,2
7773,0,1,1,0,0,2
7774,0,0,1,0,1,2
7775,0,0,1,0,1,2
7776,0,1,1,0,0,2
7777,0,1,1,0,0,2
7778,0,0,1,1,0,2
7779,1,0,1,0,0,2
7780,0,1,1,0,0,2
7781,1,0,1,0,0,2
7782,0,1,1,0,0,2
7783,0,0,1,1,0,2
7784,0,0,1,0,1,2
7785,0,0,1,0,1,2
7786,1,0,0,1,0,2
7787,0,1,1,0,0,2
7788,1,0,1,0,0,2
7789,0,0,2,0,0,2
7790,0,0,2,0,0,2
7791,0,1,1,0,0,2
7792,1,0,1,0,0,2
7793,0,0,1,0,1,2
7794,0,1,1,0,0,2
7795,0,1,1,0,0,2
7796,0,0,1,0,1,2
7797,1,0,1,0,0,2
7798,0,1,1,0,0,2
7799,0,1,1,0,0,2
7800,0,1,1,0,0,2
7801,0,0,1,0,1,2
7802,0,0,1,0,1,2
7803,0,0,1,1,0,2
7804,0,1,1,0,0,2
7805,0,1,1,0,0,2
7806,0,1,1,0,0,2
7807,0,1,1,0,0,2
7808,1,0,1,0,0,2
7809,0,0,1,0,1,2
7810,0,0,1,1,0,2
7811,0,0,1,0,1,2
7812,0,1,1,0,0,2
7813,0,1,1,0,0,2
7814,0,1,1,0,0,2
7815,0,1,1,0,0,2
7816,0,1,1,0,0,2
7817,1,0,0,1,0,2
7818,1,0,1,0,0,2
7819,0,1,1,0,0,2
7820,0,1,1,0,0,2
7821,0,0,1,0,1,2
7822,0,1,1,0,0,2
7823,0,1,1,0,0,2
7824,0,1,1,0,0,2
7825,0,1,1,0,0,2
7826,1,0,1,0,0,2
7827,0,0,1,1,0,2
7828,0,1,1,0,0,2
7829,0,1,1,0,0,2
7830,0,1,1,0,0,2
7831,0,1,1,0,0,2
7832,0,0,1,0,1,2
7833,0,0,2,0,0,2
7834,0,0,1,1,0,2
7835,0,1,1,0,0,2
7836,0,1,1,0,0,2
7837,0,0,1,0,1,2
7838,0,1,1,0,0,2
7839,1,0,1,0,0,2
7840,0,1,1,0,0,2
7841,0,1,1,0,0,2
7842,0,1,1,0,0,2
7843,0,1,1,0,0,2
7844,0,0,1,0,1,2
7845,1,0,1,0,0,2
7846,0,1,1,0,0,2
7847,1,0,1,0,0,2
7848,1,0,1,0,0,2
7849,0,1,1,0,0,2
7850,0,1,1,0,0,2
7851,0,0,1,1,0,2
7852,0,1,1,0,0,2
7853,0,0,1,0,1,2
7854,0,1,1,0,0,2
7855,1,0,1,0,0,2
7856,0,1,1,0,0,2
7857,0,1,1,0,0,2
7858,0,1,1,0,0,2
7859,1,0,0,1,0,2
7860,0,0,0,2,0,2
7861,1,0,0,1,0,2
7862,1,0,0,1,0,2
7863,1,0,0,1,0,2
7864,1,0,0,1,0,2
7865,1,0,0,1,0,2
7866,1,0,0,1,0,2
7867,1,0,0,1,0,2
7868,1,0,0,1,0,2
7869,0,0,0,2,0,2
7870,0,0,0,2,0,2
7871,1,0,0,1,0,2
7872,0,0,0,2,0,2
7873,1,0,0,1,0,2
7874,1,0,0,1,0,2
7875,0,0,0,2,0,2
7876,1,0,0,1,0,2
7877,1,0,0,1,0,2
7878,0,0,0,2,0,2
7879,1,0,0,1,0,2
7880,1,0,0,1,0,2
7881,1,0,0,1,0,2
7882,0,0,0,2,0,2
7883,0,0,0,2,0,2
7884,1,0,0,1,0,2
7885,1,0,0,1,0,2
7886,1,0,0,1,0,2
7887,1,0,0,1,0,2
7888,1,0,0,1,0,2
7889,0,0,0,2,0,2
7890,1,0,0,1,0,2
7891,0,0,0,2,0,2
7892,0,0,1,1,0,2
7893,0,0,0,2,0,2
7894,0,0,0,2,0,2
7895,1,0,0,1,0,2
7896,1,0,0,1,0,2
7897,1,0,0,1,0,2
7898,1,0,0,1,0,2
7899,0,0,0,2,0,2
7900,1,0,0,1,0,2
7901,1,0,0,1,0,2
7902,0,0,0,2,0,2
7903,1,0,0,1,0,2
7904,0,0,0,2,0,2
7905,1,0,0,1,0,2
7906,1,0,0,1,0,2
7907,0,0,0,2,0,2
7908,0,0,0,2,0,2
7909,1,0,0,1,0,2
7910,0,0,0,2,0,2
7911,0,0,0,2,0,2
7912,0,0,0,2,0,2
7913,1,0,0,1,0,2
7914,1,0,0,1,0,2
7915,1,0,0,1,0,2
7916,1,0,0,1,0,2
7917,0,0,0,2,0,2
7918,0,0,0,2,0,2
7919,0,0,0,2,0,2
7920,0,0,0,2,0,2
7921,1,0,0,1,0,2
7922,1,0,0,1,0,2
7923,1,0,0,1,0,2
7924,1,0,0,1,0,2
7925,1,0,0,1,0,2
7926,0,0,0,2,0,2
7927,1,0,0,1,0,2
7928,1,0,0,1,0,2
7929,1,0,0,1,0,2
7930,1,0,0,1,0,2
7931,1,0,0,1,0,2
7932,1,0,0,1,0,2
7933,1,0,0,1,0,2
7934,1,0,0,1,0,2
7935,1,0,0,1,0,2
7936,0,0,0,2,0,2
7937,1,0,0,1,0,2
7938,1,0,0,1,0,2
7939,1,0,0,1,0,2
7940,1,0,0,1,0,2
7941,1,0,0,1,0,2
7942,0,0,0,2,0,2
7943,1,0,0,1,0,2
7944,1,0,0,1,0,2
7945,1,0,0,1,0,2
7946,0,0,0,2,0,2
7947,0,0,0,2,0,2
7948,0,0,0,2,0,2
7949,1,0,0,1,0,2
7950,1,0,0,1,0,2
7951,0,0,0,2,0,2
7952,1,0,0,1,0,2
7953,1,0,0,1,0,2
7954,0,0,0,2,0,2
7955,1,0,0,1,0,2
7956,1,0,0,1,0,2
7957,0,0,0,2,0,2
7958,1,0,0,1,0,2
7959,1,0,0,1,0,2
7960,0,0,0,2,0,2
7961,1,0,0,1,0,2
7962,1,0,0,1,0,2
7963,1,0,0,1,0,2
7964,1,0,0,1,0,2
7965,0,0,0,2,0,2
7966,1,0,0,1,0,2
7967,1,0,0,1,0,2
7968,0,0,0,2,0,2
7969,1,0,0,1,0,2
7970,1,0,0,1,0,2
7971,1,0,0,1,0,2
7972,0,0,0,2,0,2
7973,1,0,0,1,0,2
7974,0,0,0,2,0,2
7975,0,0,0,2,0,2
7976,1,0,0,1,0,2
7977,1,0,0,1,0,2
7978,1,0,0,1,0,2
7979,0,0,0,2,0,2
7980,1,0,0,1,0,2
7981,1,0,0,1,0,2
7982,1,0,0,0,1,2
7983,1,0,0,1,0,2
7984,1,0,0,1,0,2
7985,1,0,0,0,1,2
7986,0,0,0,0,2,2
7987,1,0,0,0,1,2
7988,0,1,0,0,1,2
7989,0,0,0,0,2,2
7990,1,0,0,0,1,2
7991,1,0,0,0,1,2
7992,0,1,0,0,1,2
7993,0,1,0,0,1,2
7994,1,0,0,0,1,2
7995,1,0,0,0,1,2
7996,0,0,1,0,1,2
7997,1,0,0,0,1,2
7998,1,0,0,0,1,2
7999,1,0,0,0,1,2
8000,0,0,0,0,2,2
8001,0,0,0,0,2,2
8002,1,0,0,0,1,2
8003,1,0,0,0,1,2
8004,0,1,0,0,1,2
8005,1,0,0,0,1,2
8006,0,0,0,0,2,2
8007,0,0,0,0,2,2
8008,0,0,0,0,2,2
8009,1,0,0,0,1,2
8010,1,0,0,0,1,2
8011,1,0,0,0,1,2
8012,1,0,0,0,1,2
8013,0,1,0,0,1,2
8014,0,0,0,0,2,2
8015,1,0,0,0,1,2
8016,1,0,0,0,1,2
8017,1,0,0,0,1,2
8018,0,0,1,0,1,2
8019,0,0,0,0,2,2
8020,0,0,0,0,2,2
8021,0,0,0,0,2,2
8022,1,0,0,0,1,2
8023,1,0,0,0,1,2
8024,0,0,0,0,2,2
8025,0,1,0,0,1,2
8026,1,0,0,0,1,2
8027,0,0,0,0,2,2
8028,1,0,0,0,1,2
8029,0,0,1,0,1,2
8030,1,0,0,0,1,2
8031,1,0,0,0,1,2
8032,0,0,0,0,2,2
8033,0,0,0,0,2,2
8034,0,0,0,0,2,2
8035,1,0,0,0,1,2
8036,0,0,0,0,2,2
8037,0,2,0,0,0,2
8038,0,1,1,0,0,2
8039,0,1,1,0,0,2
8040,0,1,1,0,0,2
8041,0,1,1,0,0,2
8042,0,1,1,0,0,2
8043,0,1,1,0,0,2
8044,0,1,1,0,0,2
8045,0,1,1,0,0,2
8046,0,1,1,0,0,2
8047,0,1,1,0,0,2
8048,0,1,1,0,0,2
8049,0,1,1,0,0,2
8050,0,1,1,0,0,2
8051,0,1,1,0,0,2
8052,0,1,1,0,0,2
8053,0,2,0,0,0,2
8054,0,1,1,0,0,2
8055,0,2,0,0,0,2
8056,0,1,1,0,0,2
8057,0,1,1,0,0,2
8058,0,1,1,0,0,2
8059,0,1,1,0,0,2
8060,0,1,1,0,0,2
8061,0,2,0,0,0,2
8062,0,1,1,0,0,2
8063,0,2,0,0,0,2
8064,0,1,1,0,0,2
8065,0,1,1,0,0,2
8066,0,1,1,0,0,2
8067,0,1,1,0,0,2
8068,0,1,1,0,0,2
8069,0,1,1,0,0,2
8070,0,1,1,0,0,2
8071,0,2,0,0,0,2
8072,0,1,1,0,0,2
8073,0,1,1,0,0,2
8074,0,1,1,0,0,2
8075,0,1,1,0,0,2
8076,0,1,1,0,0,2
8077,0,1,1,0,0,2
8078,0,2,0,0,0,2
8079,0,2,0,0,0,2
8080,0,2,0,0,0,2
8081,0,1,1,0,0,2
8082,0,2,0,0,0,2
8083,0,1,1,0,0,2
8084,0,2,0,0,0,2
8085,0,1,1,0,0,2
8086,0,2,0,0,0,2
8087,0,1,1,0,0,2
8088,0,2,0,0,0,2
8089,0,2,0,0,0,2
8090,0,1,1,0,0,2
8091,0,1,1,0,0,2
8092,0,1,0,0,1,2
8093,0,1,1,0,0,2
8094,0,2,0,0,0,2
8095,0,2,0,0,0,2
8096,0,1,1,0,0,2
8097,0,2,0,0,0,2
8098,0,2,0,0,0,2
8099,0,2,0,0,0,2
8100,0,1,1,0,0,2
8101,0,2,0,0,0,2
8102,0,1,1,0,0,2
8103,0,1,1,0,0,2
8104,0,1,1,0,0,2
8105,0,1,1,0,0,2
8106,0,1,1,0,0,2
8107,0,2,0,0,0,2
8108,0,2,0,0,0,2
8109,0,1,1,0,0,2
8110,0,1,1,0,0,2
8111,0,1,1,0,0,2
8112,0,1,1,0,0,2
8113,0,1,1,0,0,2
8114,0,2,0,0,0,2
8115,0,1,1,0,0,2
8116,0,2,0,0,0,2
8117,0,1,1,0,0,2
8118,0,1,1,0,0,2
8119,0,1,1,0,0,2
8120,0,1,1,0,0,2
8121,0,1,1,0,0,2
8122,0,1,0,0,1,2
8123,0,2,0,0,0,2
8124,0,2,0,0,0,2
8125,0,1,0,0,1,2
8126,0,1,1,0,0,2
8127,0,2,0,0,0,2
8128,0,2,0,0,0,2
8129,0,2,0,0,0,2
8130,0,1,1,0,0,2
8131,0,1,1,0,0,2
8132,0,1,1,0,0,2
8133,0,2,0,0,0,2
8134,0,1,1,0,0,2
8135,0,1,1,0,0,2
8136,0,2,0,0,0,2
8137,0,1,1,0,0,2
8138,0,1,1,0,0,2
8139,0,2,0,0,0,2
8140,0,2,0,0,0,2
8141,0,1,1,0,0,2
8142,0,2,0,0,0,2
8143,0,1,1,0,0,2
8144,0,1,1,0,0,2
8145,0,1,1,0,0,2
8146,0,2,0,0,0,2
8147,0,1,1,0,0,2
8148,0,1,1,0,0,2
8149,0,1,1,0,0,2
8150,0,1,1,0,0,2
8151,0,1,1,0,0,2
8152,0,1,1,0,0,2
8153,0,1,1,0,0,2
8154,0,2,0,0,0,2
8155,0,1,1,0,0,2
8156,0,1,1,0,0,2
8157,0,2,0,0,0,2
8158,0,1,1,0,0,2
8159,0,1,1,0,0,2
8160,0,1,1,0,0,2
8161,0,1,1,0,0,2
8162,0,1,1,0,0,2
8163,0,1,0,0,1,2
8164,0,1,1,0,0,2
8165,0,2,0,0,0,2
8166,0,2,0,0,0,2
8167,0,1,0,0,1,2
8168,0,1,1,0,0,2
8169,0,1,1,0,0,2
8170,0,1,1,0,0,2
8171,0,1,1,0,0,2
8172,0,1,1,0,0,2
8173,0,1,1,0,0,2
8174,0,1,1,0,0,2
8175,0,2,0,0,0,2
8176,0,2,0,0,0,2
8177,0,2,0,0,0,2
8178,0,2,0,0,0,2
8179,0,1,1,0,0,2
8180,0,1,1,0,0,2
8181,0,2,0,0,0,2
8182,0,2,0,0,0,2
8183,0,1,1,0,0,2
8184,0,2,0,0,0,2
8185,0,1,0,0,1,2
8186,0,2,0,0,0,2
8187,0,2,0,0,0,2
8188,0,1,1,0,0,2
8189,0,2,0,0,0,2
8190,0,2,0,0,0,2
8191,0,1,1,0,0,2
8192,0,1,1,0,0,2
8193,0,2,0,0,0,2
8194,0,1,1,0,0,2
8195,0,2,0,0,0,2
8196,0,2,0,0,0,2
8197,0,2,0,0,0,2
8198,0,1,1,0,0,2
8199,0,2,0,0,0,2
8200,0,1,1,0,0,2
8201,0,2,0,0,0,2
8202,0,2,0,0,0,2
8203,0,2,0,0,0,2
8204,0,2,0,0,0,2
8205,0,2,0,0,0,2
8206,0,2,0,0,0,2
8207,0,2,0,0,0,2
8208,0,2,0,0,0,2
8209,0,2,0,0,0,2
8210,0,2,0,0,0,2
8211,0,2,0,0,0,2
8212,0,2,0,0,0,2
8213,0,2,0,0,0,2
8214,0,2,0,0,0,2
8215,0,2,0,0,0,2
8216,0,2,0,0,0,2
8217,0,2,0,0,0,2
8218,0,2,0,0,0,2
8219,0,2,0,0,0,2
8220,0,2,0,0,0,2
8221,0,2,0,0,0,2
8222,0,1,1,0,0,2
8223,0,1,1,0,0,2
8224,0,1,1,0,0,2
8225,0,1,1,0,0,2
8226,0,1,1,0,0,2
8227,0,1,1,0,0,2
8228,0,1,1,0,0,2
8229,0,1,0,0,1,2
8230,0,1,1,0,0,2
8231,0,1,1,0,0,2
8232,0,1,1,0,0,2
8233,0,1,1,0,0,2
8234,0,1,1,0,0,2
8235,0,1,1,0,0,2
8236,0,1,1,0,0,2
8237,0,1,1,0,0,2
8238,0,1,1,0,0,2
8239,0,1,1,0,0,2
8240,0,1,1,0,0,2
8241,0,1,1,0,0,2
8242,0,1,1,0,0,2
8243,0,1,1,0,0,2
8244,0,1,1,0,0,2
8245,0,1,1,0,0,2
8246,0,1,1,0,0,2
8247,0,1,1,0,0,2
8248,0,1,1,0,0,2
8249,0,1,1,0,0,2
8250,0,1,1,0,0,2
8251,0,1,1,0,0,2
8252,0,1,1,0,0,2
8253,0,1,1,0,0,2
8254,0,1,1,0,0,2
8255,0,1,1,0,0,2
8256,0,1,1,0,0,2
8257,0,1,1,0,0,2
8258,0,1,1,0,0,2
8259,0,1,1,0,0,2
8260,0,1,1,0,0,2
8261,0,1,1,0,0,2
8262,0,1,1,0,0,2
8263,0,1,1,0,0,2
8264,0,1,1,0,0,2
8265,0,1,1,0,0,2
8266,0,1,1,0,0,2
8267,0,1,1,0,0,2
8268,0,1,1,0,0,2
8269,0,1,1,0,0,2
8270,0,1,1,0,0,2
8271,0,1,1,0,0,2
8272,0,1,1,0,0,2
8273,0,1,1,0,0,2
8274,0,1,1,0,0,2
8275,0,1,1,0,0,2
8276,0,1,1,0,0,2
8277,0,1,1,0,0,2
8278,0,1,1,0,0,2
8279,0,1,1,0,0,2
8280,0,1,1,0,0,2
8281,0,1,1,0,0,2
8282,0,1,1,0,0,2
8283,0,1,1,0,0,2
8284,0,1,1,0,0,2
8285,0,1,0,0,1,2
8286,0,1,1,0,0,2
8287,0,1,1,0,0,2
8288,0,1,1,0,0,2
8289,0,1,1,0,0,2
8290,0,1,1,0,0,2
8291,0,1,1,0,0,2
8292,0,1,1,0,0,2
8293,0,1,1,0,0,2
8294,0,1,1,0,0,2
8295,0,1,1,0,0,2
8296,0,1,1,0,0,2
8297,0,1,1,0,0,2
8298,0,1,1,0,0,2
8299,0,1,1,0,0,2
8300,0,1,1,0,0,2
8301,0,1,1,0,0,2
8302,0,1,1,0,0,2
8303,0,1,1,0,0,2
8304,0,1,1,0,0,2
8305,0,1,1,0,0,2
8306,0,1,1,0,0,2
8307,0,1,1,0,0,2
8308,0,1,1,0,0,2
8309,0,1,1,0,0,2
8310,0,1,1,0,0,2
8311,0,1,1,0,0,2
8312,0,1,0,0,1,2
8313,0,1,1,0,0,2
8314,0,1,1,0,0,2
8315,0,1,1,0,0,2
8316,0,1,1,0,0,2
8317,0,1,1,0,0,2
8318,0,1,1,0,0,2
8319,0,1,1,0,0,2
8320,0,1,1,0,0,2
8321,0,1,1,0,0,2
8322,0,1,1,0,0,2
8323,0,1,1,0,0,2
8324,0,1,1,0,0,2
8325,0,1,1,0,0,2
8326,0,1,1,0,0,2
8327,0,1,1,0,0,2
8328,0,1,1,0,0,2
8329,0,1,1,0,0,2
8330,0,1,1,0,0,2
8331,0,1,1,0,0,2
8332,0,1,1,0,0,2
8333,0,1,1,0,0,2
8334,0,1,1,0,0,2
8335,0,1,1,0,0,2
8336,0,1,1,0,0,2
8337,0,1,1,0,0,2
8338,0,1,1,0,0,2
8339,0,1,0,0,1,2
8340,0,1,1,0,0,2
8341,0,1,1,0,0,2
8342,0,1,1,0,0,2
8343,0,1,1,0,0,2
8344,0,1,1,0,0,2
8345,0,1,1,0,0,2
8346,0,1,1,0,0,2
8347,0,1,1,0,0,2
8348,0,1,1,0,0,2
8349,0,1,1,0,0,2
8350,0,1,1,0,0,2
8351,0,1,1,0,0,2
8352,0,1,1,0,0,2
8353,0,1,1,0,0,2
8354,0,1,1,0,0,2
8355,0,1,1,0,0,2
8356,0,1,1,0,0,2
8357,0,1,1,0,0,2
8358,0,1,1,0,0,2
8359,0,1,1,0,0,2
8360,0,1,1,0,0,2
8361,0,1,1,0,0,2
8362,0,1,1,0,0,2
8363,0,1,1,0,0,2
8364,0,1,1,0,0,2
8365,0,1,1,0,0,2
8366,0,1,0,0,1,2
8367,0,1,1,0,0,2
8368,0,1,1,0,0,2
8369,0,1,1,0,0,2
8370,0,1,1,0,0,2
8371,0,1,1,0,0,2
8372,0,1,1,0,0,2
8373,0,1,1,0,0,2
8374,0,1,1,0,0,2
8375,0,1,1,0,0,2
8376,0,1,1,0,0,2
8377,0,1,1,0,0,2
8378,0,1,1,0,0,2
8379,0,0,1,0,1,2
8380,0,1,1,0,0,2
8381,0,1,1,0,0,2
8382,0,1,1,0,0,2
8383,0,1,1,0,0,2
8384,0,1,1,0,0,2
8385,0,1,1,0,0,2
8386,0,1,1,0,0,2
8387,0,1,1,0,0,2
8388,0,1,1,0,0,2
8389,0,1,1,0,0,2
8390,0,1,1,0,0,2
8391,0,1,1,0,0,2
8392,0,1,1,0,0,2
8393,0,1,1,0,0,2
8394,0,1,1,0,0,2
8395,0,1,1,0,0,2
8396,0,1,1,0,0,2
8397,0,1,1,0,0,2
8398,0,1,1,0,0,2
8399,0,1,1,0,0,2
8400,0,1,1,0,0,2
8401,0,1,1,0,0,2
8402,0,1,1,0,0,2
8403,0,1,1,0,0,2
8404,0,1,1,0,0,2
8405,0,1,1,0,0,2
8406,0,1,1,0,0,2
8407,0,1,1,0,0,2
8408,0,1,1,0,0,2
8409,0,1,1,0,0,2
8410,0,1,1,0,0,2
8411,0,1,1,0,0,2
8412,0,1,1,0,0,2
8413,0,1,1,0,0,2
8414,0,1,1,0,0,2
8415,0,1,1,0,0,2
8416,0,1,1,0,0,2
8417,0,1,1,0,0,2
8418,0,1,1,0,0,2
8419,0,1,1,0,0,2
8420,0,0,2,0,0,2
8421,0,1,1,0,0,2
8422,0,1,1,0,0,2
8423,0,1,1,0,0,2
8424,0,1,1,0,0,2
8425,0,1,1,0,0,2
8426,0,1,1,0,0,2
8427,0,1,1,0,0,2
8428,0,1,1,0,0,2
8429,0,1,1,0,0,2
8430,0,1,1,0,0,2
8431,0,1,1,0,0,2
8432,0,1,1,0,0,2
8433,0,1,1,0,0,2
8434,0,1,1,0,0,2
8435,0,1,1,0,0,2
8436,0,1,1,0,0,2
8437,0,1,1,0,0,2
8438,0,1,1,0,0,2
8439,0,1,1,0,0,2
8440,0,1,1,0,0,2
8441,0,1,1,0,0,2
8442,0,1,1,0,0,2
8443,0,1,1,0,0,2
8444,0,1,1,0,0,2
8445,0,1,1,0,0,2
8446,0,1,1,0,0,2
8447,0,1,1,0,0,2
8448,0,1,1,0,0,2
8449,0,1,1,0,0,2
8450,0,1,1,0,0,2
8451,0,1,1,0,0,2
8452,0,1,1,0,0,2
8453,0,1,1,0,0,2
8454,0,1,1,0,0,2
8455,0,1,1,0,0,2
8456,0,1,1,0,0,2
8457,0,1,1,0,0,2
8458,0,1,1,0,0,2
8459,0,1,1,0,0,2
8460,0,1,1,0,0,2
8461,0,1,1,0,0,2
8462,0,0,2,0,0,2
8463,0,1,1,0,0,2
8464,0,1,1,0,0,2
8465,0,1,1,0,0,2
8466,0,1,1,0,0,2
8467,0,1,1,0,0,2
8468,0,1,1,0,0,2
8469,0,1,0,0,1,2
8470,0,1,1,0,0,2
8471,0,1,1,0,0,2
8472,0,1,1,0,0,2
8473,0,1,1,0,0,2
8474,0,1,1,0,0,2
8475,0,1,1,0,0,2
8476,0,1,1,0,0,2
8477,0,1,1,0,0,2
8478,0,1,1,0,0,2
8479,0,1,1,0,0,2
8480,0,1,1,0,0,2
8481,0,1,1,0,0,2
8482,0,1,1,0,0,2
8483,0,1,1,0,0,2
8484,0,1,1,0,0,2
8485,0,1,1,0,0,2
8486,0,0,1,0,1,2
8487,0,1,1,0,0,2
8488,0,1,1,0,0,2
8489,0,1,0,0,1,2
8490,0,0,2,0,0,2
8491,0,1,1,0,0,2
8492,0,1,1,0,0,2
8493,0,1,1,0,0,2
8494,0,1,1,0,0,2
8495,0,1,1,0,0,2
8496,0,1,1,0,0,2
8497,0,1,1,0,0,2
8498,0,1,1,0,0,2
8499,0,1,1,0,0,2
8500,0,1,1,0,0,2
8501,0,0,2,0,0,2
8502,0,1,1,0,0,2
8503,0,1,1,0,0,2
8504,0,1,1,0,0,2
8505,0,1,1,0,0,2
8506,0,1,1,0,0,2
8507,0,1,1,0,0,2
8508,0,1,1,0,0,2
8509,0,1,1,0,0,2
8510,0,1,1,0,0,2
8511,0,1,1,0,0,2
8512,0,1,1,0,0,2
8513,0,1,1,0,0,2
8514,0,1,1,0,0,2
8515,0,1,1,0,0,2
8516,0,1,1,0,0,2
8517,0,1,1,0,0,2
8518,0,1,1,0,0,2
8519,0,1,1,0,0,2
8520,0,1,1,0,0,2
8521,0,1,1,0,0,2
8522,0,1,1,0,0,2
8523,0,1,1,0,0,2
8524,0,0,1,0,1,2
8525,0,1,1,0,0,2
8526,0,1,1,0,0,2
8527,0,1,1,0,0,2
8528,0,1,1,0,0,2
8529,0,1,1,0,0,2
8530,0,1,1,0,0,2
8531,0,0,2,0,0,2
8532,0,1,1,0,0,2
8533,0,1,1,0,0,2
8534,0,1,1,0,0,2
8535,0,1,1,0,0,2
8536,0,1,1,0,0,2
8537,0,1,1,0,0,2
8538,0,1,1,0,0,2
8539,0,1,1,0,0,2
8540,0,1,1,0,0,2
8541,0,1,1,0,0,2
8542,0,1,1,0,0,2
8543,0,1,1,0,0,2
8544,0,1,1,0,0,2
8545,0,1,1,0,0,2
8546,0,1,1,0,0,2
8547,0,1,1,0,0,2
8548,0,1,1,0,0,2
8549,0,1,1,0,0,2
8550,0,1,1,0,0,2
8551,0,1,1,0,0,2
8552,0,1,1,0,0,2
8553,0,1,1,0,0,2
8554,0,1,1,0,0,2
8555,0,1,1,0,0,2
8556,0,1,1,0,0,2
8557,0,1,1,0,0,2
8558,0,1,1,0,0,2
8559,0,1,1,0,0,2
8560,0,1,1,0,0,2
8561,0,1,1,0,0,2
8562,0,1,1,0,0,2
8563,0,1,1,0,0,2
8564,0,1,1,0,0,2
8565,0,1,1,0,0,2
8566,0,1,1,0,0,2
8567,0,1,1,0,0,2
8568,0,1,1,0,0,2
8569,0,1,1,0,0,2
8570,0,1,1,0,0,2
8571,0,1,1,0,0,2
8572,0,1,1,0,0,2
8573,0,1,1,0,0,2
8574,0,1,1,0,0,2
8575,0,1,1,0,0,2
8576,0,1,1,0,0,2
8577,0,1,1,0,0,2
8578,0,1,1,0,0,2
8579,0,1,1,0,0,2
8580,0,1,1,0,0,2
8581,0,1,1,0,0,2
8582,0,1,1,0,0,2
8583,0,1,1,0,0,2
8584,0,1,1,0,0,2
8585,0,1,1,0,0,2
8586,0,1,1,0,0,2
8587,0,1,1,0,0,2
8588,0,1,1,0,0,2
8589,0,1,1,0,0,2
8590,0,1,1,0,0,2
8591,0,1,1,0,0,2
8592,0,1,1,0,0,2
8593,0,1,1,0,0,2
8594,0,1,1,0,0,2
8595,0,1,1,0,0,2
8596,0,1,1,0,0,2
8597,0,1,1,0,0,2
8598,0,1,1,0,0,2
8599,0,1,1,0,0,2
8600,0,0,2,0,0,2
8601,0,1,1,0,0,2
8602,0,1,1,0,0,2
8603,0,1,1,0,0,2
8604,0,1,1,0,0,2
8605,0,1,1,0,0,2
8606,0,1,1,0,0,2
8607,0,1,1,0,0,2
8608,0,1,1,0,0,2
8609,0,1,1,0,0,2
8610,0,1,1,0,0,2
8611,0,1,1,0,0,2
8612,0,1,1,0,0,2
8613,0,1,1,0,0,2
8614,0,1,1,0,0,2
8615,0,1,1,0,0,2
8616,0,1,1,0,0,2
8617,0,1,1,0,0,2
8618,0,1,1,0,0,2
8619,0,1,1,0,0,2
8620,0,1,1,0,0,2
8621,0,1,1,0,0,2
8622,0,1,1,0,0,2
8623,0,1,1,0,0,2
8624,0,1,1,0,0,2
8625,0,1,1,0,0,2
8626,0,1,1,0,0,2
8627,0,1,1,0,0,2
8628,0,1,1,0,0,2
8629,0,1,1,0,0,2
8630,0,1,1,0,0,2
8631,0,1,1,0,0,2
8632,0,1,1,0,0,2
8633,0,1,1,0,0,2
8634,0,1,1,0,0,2
8635,0,1,1,0,0,2
8636,0,1,1,0,0,2
8637,0,1,1,0,0,2
8638,0,1,1,0,0,2
8639,0,1,1,0,0,2
8640,0,1,1,0,0,2
8641,0,1,1,0,0,2
8642,0,1,0,0,1,2
8643,0,1,1,0,0,2
8644,0,1,1,0,0,2
8645,0,1,1,0,0,2
8646,0,1,1,0,0,2
8647,0,1,1,0,0,2
8648,0,1,1,0,0,2
8649,0,1,1,0,0,2
8650,0,1,1,0,0,2
8651,0,1,1,0,0,2
8652,0,1,1,0,0,2
8653,0,0,2,0,0,2
8654,0,1,1,0,0,2
8655,0,1,1,0,0,2
8656,0,1,1,0,0,2
8657,0,1,1,0,0,2
8658,0,1,1,0,0,2
8659,0,1,1,0,0,2
8660,0,1,1,0,0,2
8661,0,1,1,0,0,2
8662,0,1,1,0,0,2
8663,0,1,1,0,0,2
8664,0,1,1,0,0,2
8665,0,1,1,0,0,2
8666,0,1,1,0,0,2
8667,0,1,1,0,0,2
8668,0,1,1,0,0,2
8669,0,1,1,0,0,2
8670,0,1,1,0,0,2
8671,0,1,1,0,0,2
8672,0,1,1,0,0,2
8673,0,1,1,0,0,2
8674,0,1,1,0,0,2
8675,0,1,1,0,0,2
8676,0,1,1,0,0,2
8677,0,1,1,0,0,2
8678,0,1,1,0,0,2
8679,0,1,1,0,0,2
8680,0,1,1,0,0,2
8681,0,1,1,0,0,2
8682,0,1,1,0,0,2
8683,0,1,1,0,0,2
8684,0,1,1,0,0,2
8685,0,1,1,0,0,2
8686,0,1,1,0,0,2
8687,0,1,1,0,0,2
8688,0,1,1,0,0,2
8689,0,1,1,0,0,2
8690,0,1,1,0,0,2
8691,0,1,1,0,0,2
8692,0,1,1,0,0,2
8693,0,1,1,0,0,2
8694,0,1,1,0,0,2
8695,0,1,1,0,0,2
8696,0,1,1,0,0,2
8697,0,1,1,0,0,2
8698,0,1,1,0,0,2
8699,0,1,1,0,0,2
8700,0,1,1,0,0,2
8701,0,1,1,0,0,2
8702,0,1,1,0,0,2
8703,0,1,1,0,0,2
8704,0,1,1,0,0,2
8705,0,1,1,0,0,2
8706,0,1,1,0,0,2
8707,0,1,1,0,0,2
8708,0,1,1,0,0,2
8709,0,1,1,0,0,2
8710,0,0,1,0,1,2
8711,0,1,1,0,0,2
8712,0,1,1,0,0,2
8713,0,1,1,0,0,2
8714,0,1,1,0,0,2
8715,0,1,1,0,0,2
8716,0,1,1,0,0,2
8717,0,1,1,0,0,2
8718,0,1,1,0,0,2
8719,0,1,1,0,0,2
8720,0,1,1,0,0,2
8721,0,1,1,0,0,2
8722,0,1,1,0,0,2
8723,0,1,1,0,0,2
8724,0,1,1,0,0,2
8725,0,1,1,0,0,2
8726,0,1,1,0,0,2
8727,0,1,1,0,0,2
8728,0,1,1,0,0,2
8729,0,1,1,0,0,2
8730,0,1,1,0,0,2
8731,0,1,1,0,0,2
8732,0,1,1,0,0,2
8733,0,1,1,0,0,2
8734,0,1,0,0,1,2
8735,0,1,1,0,0,2
8736,0,1,1,0,0,2
8737,0,1,1,0,0,2
8738,0,1,1,0,0,2
8739,0,1,1,0,0,2
8740,0,1,1,0,0,2
8741,0,1,1,0,0,2
8742,0,1,0,0,1,2
8743,0,1,0,0,1,2
8744,0,1,1,0,0,2
8745,0,1,1,0,0,2
8746,0,1,1,0,0,2
8747,0,1,1,0,0,2
8748,0,1,1,0,0,2
8749,0,1,1,0,0,2
8750,0,1,1,0,0,2
8751,0,1,1,0,0,2
8752,0,1,1,0,0,2
8753,0,1,1,0,0,2
8754,0,1,1,0,0,2
8755,0,1,1,0,0,2
8756,0,1,1,0,0,2
8757,0,1,1,0,0,2
8758,0,1,1,0,0,2
8759,0,1,1,0,0,2
8760,0,1,1,0,0,2
8761,0,1,1,0,0,2
8762,0,1,1,0,0,2
8763,0,1,1,0,0,2
8764,0,0,1,0,1,2
8765,0,1,1,0,0,2
8766,0,1,1,0,0,2
8767,0,1,1,0,0,2
8768,0,1,1,0,0,2
8769,0,1,1,0,0,2
8770,0,1,1,0,0,2
8771,0,1,1,0,0,2
8772,0,1,1,0,0,2
8773,0,1,0,0,1,2
8774,0,1,1,0,0,2
8775,0,1,1,0,0,2
8776,0,1,0,0,1,2
8777,0,1,1,0,0,2
8778,0,1,1,0,0,2
8779,0,1,1,0,0,2
8780,0,1,1,0,0,2
8781,0,1,1,0,0,2
8782,0,1,1,0,0,2
8783,0,1,1,0,0,2
8784,0,1,1,0,0,2
8785,0,1,1,0,0,2
8786,0,1,1,0,0,2
8787,0,1,1,0,0,2
8788,0,1,1,0,0,2
8789,0,1,1,0,0,2
8790,0,1,1,0,0,2
8791,0,1,1,0,0,2
8792,0,1,1,0,0,2
8793,0,1,1,0,0,2
8794,0,1,1,0,0,2
8795,0,1,1,0,0,2
8796,0,1,1,0,0,2
8797,0,1,1,0,0,2
8798,0,1,1,0,0,2
8799,0,1,1,0,0,2
8800,0,1,1,0,0,2
8801,0,1,1,0,0,2
8802,0,1,1,0,0,2
8803,0,1,1,0,0,2
8804,0,1,1,0,0,2
8805,0,1,1,0,0,2
8806,0,1,1,0,0,2
8807,0,1,1,0,0,2
8808,0,1,1,0,0,2
8809,0,1,1,0,0,2
8810,0,1,1,0,0,2
8811,0,1,1,0,0,2
8812,0,1,1,0,0,2
8813,0,1,1,0,0,2
8814,0,1,1,0,0,2
8815,0,1,1,0,0,2
8816,0,1,1,0,0,2
8817,0,1,1,0,0,2
8818,0,1,1,0,0,2
8819,0,1,1,0,0,2
8820,0,1,1,0,0,2
8821,0,1,1,0,0,2
8822,0,1,1,0,0,2
8823,0,1,1,0,0,2
8824,0,1,1,0,0,2
8825,0,1,1,0,0,2
8826,0,1,1,0,0,2
8827,0,1,1,0,0,2
8828,0,1,1,0,0,2
8829,0,1,1,0,0,2
8830,0,1,1,0,0,2
8831,0,1,1,0,0,2
8832,0,1,1,0,0,2
8833,0,1,1,0,0,2
8834,0,1,0,0,1,2
8835,0,1,1,0,0,2
8836,0,1,1,0,0,2
8837,0,1,1,0,0,2
8838,0,1,1,0,0,2
8839,0,1,1,0,0,2
8840,0,1,1,0,0,2
8841,0,1,1,0,0,2
8842,0,1,1,0,0,2
8843,0,1,1,0,0,2
8844,0,1,1,0,0,2
8845,0,1,1,0,0,2
8846,0,1,1,0,0,2
8847,0,1,1,0,0,2
8848,0,1,1,0,0,2
8849,0,1,1,0,0,2
8850,0,1,1,0,0,2
8851,0,1,1,0,0,2
8852,0,1,1,0,0,2
8853,0,1,1,0,0,2
8854,0,1,1,0,0,2
8855,0,1,1,0,0,2
8856,0,1,1,0,0,2
8857,0,1,1,0,0,2
8858,0,1,1,0,0,2
8859,0,1,1,0,0,2
8860,0,1,1,0,0,2
8861,0,1,1,0,0,2
8862,0,1,1,0,0,2
8863,0,1,1,0,0,2
8864,0,1,1,0,0,2
8865,0,1,1,0,0,2
8866,0,1,1,0,0,2
8867,0,1,1,0,0,2
8868,0,1,1,0,0,2
8869,0,1,1,0,0,2
8870,0,1,1,0,0,2
8871,0,1,1,0,0,2
8872,0,1,1,0,0,2
8873,0,1,1,0,0,2
8874,0,1,1,0,0,2
8875,0,1,1,0,0,2
8876,0,1,1,0,0,2
8877,0,1,1,0,0,2
8878,0,1,1,0,0,2
8879,0,1,1,0,0,2
8880,0,1,1,0,0,2
8881,0,1,1,0,0,2
8882,0,1,1,0,0,2
8883,0,1,1,0,0,2
8884,0,1,1,0,0,2
8885,0,1,1,0,0,2
8886,0,1,0,0,1,2
8887,0,1,1,0,0,2
8888,0,1,1,0,0,2
8889,0,1,1,0,0,2
8890,0,1,1,0,0,2
8891,0,1,1,0,0,2
8892,0,1,1,0,0,2
8893,0,1,1,0,0,2
8894,0,1,1,0,0,2
8895,0,1,1,0,0,2
8896,0,1,1,0,0,2
8897,0,1,1,0,0,2
8898,0,1,1,0,0,2
8899,0,1,1,0,0,2
8900,0,1,1,0,0,2
8901,0,1,1,0,0,2
8902,0,1,1,0,0,2
8903,0,1,1,0,0,2
8904,0,1,1,0,0,2
8905,0,1,1,0,0,2
8906,0,1,1,0,0,2
8907,0,1,1,0,0,2
8908,0,1,1,0,0,2
8909,0,1,1,0,0,2
8910,0,1,1,0,0,2
8911,0,1,1,0,0,2
8912,0,1,1,0,0,2
8913,0,1,1,0,0,2
8914,0,1,1,0,0,2
8915,0,1,1,0,0,2
8916,0,0,1,0,1,2
8917,0,1,1,0,0,2
8918,0,1,0,0,1,2
8919,0,1,1,0,0,2
8920,0,1,1,0,0,2
8921,0,1,1,0,0,2
8922,0,1,1,0,0,2
8923,0,1,1,0,0,2
8924,0,1,1,0,0,2
8925,0,1,1,0,0,2
8926,0,1,1,0,0,2
8927,0,1,1,0,0,2
8928,0,1,1,0,0,2
8929,0,1,1,0,0,2
8930,0,1,1,0,0,2
8931,0,1,1,0,0,2
8932,0,1,1,0,0,2
8933,0,1,1,0,0,2
8934,0,1,1,0,0,2
8935,0,1,1,0,0,2
8936,0,1,0,0,1,2
8937,0,1,1,0,0,2
8938,0,1,1,0,0,2
8939,0,1,1,0,0,2
8940,0,1,1,0,0,2
8941,0,1,1,0,0,2
8942,0,1,0,0,1,2
8943,0,1,1,0,0,2
8944,0,1,1,0,0,2
8945,0,1,1,0,0,2
8946,0,1,1,0,0,2
8947,0,1,1,0,0,2
8948,0,1,1,0,0,2
8949,0,1,1,0,0,2
8950,0,1,1,0,0,2
8951,0,1,1,0,0,2
8952,0,1,1,0,0,2
8953,0,1,1,0,0,2
8954,0,1,1,0,0,2
8955,0,1,1,0,0,2
8956,0,1,1,0,0,2
8957,0,1,1,0,0,2
8958,0,1,1,0,0,2
8959,0,1,1,0,0,2
8960,0,1,1,0,0,2
8961,0,1,1,0,0,2
8962,0,1,1,0,0,2
8963,0,1,1,0,0,2
8964,0,1,1,0,0,2
8965,0,1,1,0,0,2
8966,0,1,1,0,0,2
8967,0,1,1,0,0,2
8968,0,1,1,0,0,2
8969,0,1,0,1,0,2
8970,0,1,1,0,0,2
8971,0,1,1,0,0,2
8972,0,1,1,0,0,2
8973,0,1,1,0,0,2
8974,0,1,1,0,0,2
8975,0,1,1,0,0,2
8976,0,1,1,0,0,2
8977,0,1,1,0,0,2
8978,0,1,1,0,0,2
8979,0,1,1,0,0,2
8980,0,1,1,0,0,2
8981,0,1,1,0,0,2
8982,0,1,1,0,0,2
8983,0,1,1,0,0,2
8984,0,1,1,0,0,2
8985,0,1,1,0,0,2
8986,0,1,1,0,0,2
8987,0,1,1,0,0,2
8988,0,1,1,0,0,2
8989,0,1,1,0,0,2
8990,0,1,1,0,0,2
8991,0,1,1,0,0,2
8992,0,1,1,0,0,2
8993,0,1,1,0,0,2
8994,0,1,1,0,0,2
8995,0,1,1,0,0,2
8996,0,1,1,0,0,2
8997,0,1,1,0,0,2
8998,0,1,1,0,0,2
8999,0,1,1,0,0,2
9000,0,1,1,0,0,2
9001,0,1,1,0,0,2
9002,0,1,1,0,0,2
9003,0,1,1,0,0,2
9004,0,1,1,0,0,2
9005,0,1,1,0,0,2
9006,0,1,1,0,0,2
9007,0,1,1,0,0,2
9008,0,1,1,0,0,2
9009,0,1,1,0,0,2
9010,0,1,1,0,0,2
9011,0,1,1,0,0,2
9012,0,1,1,0,0,2
9013,0,1,1,0,0,2
9014,0,1,1,0,0,2
9015,0,1,1,0,0,2
9016,0,1,1,0,0,2
9017,0,1,1,0,0,2
9018,0,1,1,0,0,2
9019,0,1,1,0,0,2
9020,0,1,1,0,0,2
9021,0,1,1,0,0,2
9022,0,1,1,0,0,2
9023,0,1,1,0,0,2
9024,0,1,1,0,0,2
9025,0,1,1,0,0,2
9026,0,1,1,0,0,2
9027,0,1,1,0,0,2
9028,0,1,1,0,0,2
9029,0,1,1,0,0,2
9030,0,1,1,0,0,2
9031,0,1,1,0,0,2
9032,0,1,1,0,0,2
9033,0,1,1,0,0,2
9034,0,1,1,0,0,2
9035,0,1,1,0,0,2
9036,0,1,1,0,0,2
9037,0,1,1,0,0,2
9038,0,1,1,0,0,2
9039,0,1,1,0,0,2
9040,0,1,1,0,0,2
9041,0,1,1,0,0,2
9042,0,1,1,0,0,2
9043,0,1,1,0,0,2
9044,0,1,1,0,0,2
9045,0,1,1,0,0,2
9046,0,1,1,0,0,2
9047,0,1,1,0,0,2
9048,0,1,0,0,1,2
9049,0,1,1,0,0,2
9050,0,1,1,0,0,2
9051,0,1,1,0,0,2
9052,0,1,1,0,0,2
9053,0,1,1,0,0,2
9054,0,1,1,0,0,2
9055,0,1,1,0,0,2
9056,0,1,1,0,0,2
9057,0,1,1,0,0,2
9058,0,1,1,0,0,2
9059,0,1,1,0,0,2
9060,0,1,1,0,0,2
9061,0,1,1,0,0,2
9062,0,1,1,0,0,2
9063,0,1,0,0,1,2
9064,0,1,1,0,0,2
9065,0,1,1,0,0,2
9066,0,1,1,0,0,2
9067,0,1,1,0,0,2
9068,0,1,1,0,0,2
9069,0,1,1,0,0,2
9070,0,1,1,0,0,2
9071,0,1,1,0,0,2
9072,0,1,1,0,0,2
9073,0,1,1,0,0,2
9074,0,1,1,0,0,2
9075,0,1,1,0,0,2
9076,0,1,1,0,0,2
9077,0,1,1,0,0,2
9078,0,1,1,0,0,2
9079,0,1,1,0,0,2
9080,0,1,1,0,0,2
9081,0,1,1,0,0,2
9082,0,1,1,0,0,2
9083,0,1,1,0,0,2
9084,0,1,1,0,0,2
9085,0,1,1,0,0,2
9086,0,1,1,0,0,2
9087,0,1,1,0,0,2
9088,0,1,1,0,0,2
9089,0,1,1,0,0,2
9090,0,1,1,0,0,2
9091,0,1,1,0,0,2
9092,0,1,1,0,0,2
9093,0,1,1,0,0,2
9094,0,1,1,0,0,2
9095,0,1,1,0,0,2
9096,0,1,1,0,0,2
9097,0,1,1,0,0,2
9098,0,1,0,0,1,2
9099,0,1,1,0,0,2
9100,0,1,0,0,1,2
9101,0,1,1,0,0,2
9102,0,1,1,0,0,2
9103,0,1,1,0,0,2
9104,0,1,1,0,0,2
9105,0,1,1,0,0,2
9106,0,1,1,0,0,2
9107,0,1,1,0,0,2
9108,0,1,1,0,0,2
9109,0,1,1,0,0,2
9110,0,1,1,0,0,2
9111,0,1,1,0,0,2
9112,0,1,1,0,0,2
9113,0,1,1,0,0,2
9114,0,1,1,0,0,2
9115,0,1,1,0,0,2
9116,0,1,1,0,0,2
9117,0,1,1,0,0,2
9118,0,1,1,0,0,2
9119,0,1,1,0,0,2
9120,0,1,1,0,0,2
9121,0,1,1,0,0,2
9122,0,1,1,0,0,2
9123,0,1,1,0,0,2
9124,0,1,1,0,0,2
9125,0,1,1,0,0,2
9126,0,1,1,0,0,2
9127,0,1,1,0,0,2
9128,0,1,1,0,0,2
9129,0,1,1,0,0,2
9130,0,1,1,0,0,2
9131,0,1,1,0,0,2
9132,0,1,1,0,0,2
9133,0,1,1,0,0,2
9134,0,1,1,0,0,2
9135,0,1,1,0,0,2
9136,0,1,1,0,0,2
9137,0,1,1,0,0,2
9138,0,1,1,0,0,2
9139,0,1,1,0,0,2
9140,0,1,1,0,0,2
9141,0,1,1,0,0,2
9142,0,1,1,0,0,2
9143,0,1,1,0,0,2
9144,0,1,1,0,0,2
9145,0,1,1,0,0,2
9146,0,1,0,0,1,2
9147,0,1,1,0,0,2
9148,0,1,1,0,0,2
9149,0,1,1,0,0,2
9150,0,1,1,0,0,2
9151,0,1,1,0,0,2
9152,0,1,1,0,0,2
9153,0,1,1,0,0,2
9154,0,1,1,0,0,2
9155,0,1,1,0,0,2
9156,0,1,1,0,0,2
9157,0,1,0,0,1,2
9158,0,1,1,0,0,2
9159,0,1,1,0,0,2
9160,0,1,1,0,0,2
9161,0,1,1,0,0,2
9162,0,1,1,0,0,2
9163,0,1,1,0,0,2
9164,0,1,1,0,0,2
9165,0,1,0,0,1,2
9166,0,1,1,0,0,2
9167,0,1,1,0,0,2
9168,0,1,1,0,0,2
9169,0,1,1,0,0,2
9170,0,1,1,0,0,2
9171,0,1,1,0,0,2
9172,0,1,1,0,0,2
9173,0,1,1,0,0,2
9174,0,1,1,0,0,2
9175,0,1,1,0,0,2
9176,0,1,1,0,0,2
9177,0,1,1,0,0,2
9178,0,1,0,0,1,2
9179,0,0,0,2,0,2
9180,0,0,0,2,0,2
9181,0,1,0,1,0,2
9182,0,1,0,0,1,2
9183,0,0,0,2,0,2
9184,0,1,0,1,0,2
9185,0,0,0,1,1,2
9186,0,1,0,1,0,2
9187,0,1,0,1,0,2
9188,0,0,0,2,0,2
9189,0,1,0,0,1,2
9190,0,0,0,0,2,2
9191,0,0,0,0,2,2
9192,0,1,0,0,1,2
9193,0,0,1,0,1,2
9194,0,1,0,0,1,2
9195,0,1,0,0,1,2
9196,0,1,0,0,1,2
9197,0,1,0,0,1,2
9198,0,1,0,0,1,2
9199,0,1,0,0,1,2
9200,0,0,1,0,1,2
9201,0,1,0,0,1,2
9202,0,1,0,0,1,2
9203,0,1,0,0,1,2
9204,0,1,0,0,1,2
9205,0,1,0,0,1,2
9206,0,1,0,0,1,2
9207,0,1,0,0,1,2
9208,0,0,0,0,2,2
9209,0,0,0,0,2,2
9210,0,1,0,0,1,2
9211,0,1,0,0,1,2
9212,0,0,0,0,2,2
9213,0,1,0,0,1,2
9214,0,1,0,0,1,2
9215,0,1,0,0,1,2
9216,0,1,0,0,1,2
9217,0,1,0,0,1,2
9218,0,1,0,0,1,2
9219,0,1,0,0,1,2
9220,0,1,0,0,1,2
9221,0,1,0,0,1,2
9222,0,1,0,0,1,2
9223,0,1,0,0,1,2
9224,0,0,0,0,2,2
9225,0,1,0,0,1,2
9226,0,1,0,0,1,2
9227,0,1,0,0,1,2
9228,0,0,0,0,2,2
9229,0,1,0,0,1,2
9230,0,1,0,0,1,2
9231,0,1,0,0,1,2
9232,0,0,0,0,2,2
9233,0,1,0,0,1,2
9234,0,1,0,0,1,2
9235,0,1,0,0,1,2
9236,0,1,0,0,1,2
9237,0,1,0,0,1,2
9238,0,0,2,0,0,2
9239,0,0,2,0,0,2
9240,0,0,2,0,0,2
9241,0,0,2,0,0,2
9242,0,0,2,0,0,2
9243,0,0,2,0,0,2
9244,0,0,2,0,0,2
9245,0,0,2,0,0,2
9246,0,0,2,0,0,2
9247,0,0,2,0,0,2
9248,0,0,2,0,0,2
9249,0,0,2,0,0,2
9250,0,0,2,0,0,2
9251,0,0,2,0,0,2
9252,0,0,2,0,0,2
9253,0,0,2,0,0,2
9254,0,0,2,0,0,2
9255,0,0,2,0,0,2
9256,0,0,2,0,0,2
9257,0,0,2,0,0,2
9258,0,0,2,0,0,2
9259,0,0,2,0,0,2
9260,0,0,2,0,0,2
9261,0,0,2,0,0,2
9262,0,0,2,0,0,2
9263,0,0,2,0,0,2
9264,0,0,2,0,0,2
9265,0,0,2,0,0,2
9266,0,0,2,0,0,2
9267,0,0,2,0,0,2
9268,0,0,2,0,0,2
9269,0,0,1,0,1,2
9270,0,0,1,0,1,2
9271,0,0,1,1,0,2
9272,0,0,1,1,0,2
9273,0,0,0,2,0,2
9274,0,0,0,0,2,2
9275,0,0,1,0,1,2
9276,0,0,1,0,1,2
9277,0,0,0,0,2,2
9278,0,0,1,0,1,2
9279,0,0,1,0,1,2
9280,0,0,1,0,1,2
9281,0,0,1,0,1,2
9282,0,0,1,0,1,2
9283,0,0,1,0,1,2
9284,0,0,0,0,2,2
9285,0,0,1,0,1,2
9286,0,0,0,0,2,2
9287,0,0,1,0,1,2
9288,0,0,1,0,1,2
9289,0,0,1,0,1,2
9290,0,0,1,0,1,2
9291,0,0,1,0,1,2
9292,0,0,0,0,2,2
9293,0,0,0,0,2,2
9294,0,0,1,0,1,2
9295,0,0,0,0,2,2
9296,0,0,1,0,1,2
9297,0,0,0,0,2,2
9298,0,0,1,0,1,2
9299,0,0,0,0,2,2
9300,0,0,0,0,2,2
9301,0,0,1,0,1,2
9302,0,0,0,0,2,2
9303,0,0,1,0,1,2
9304,0,0,1,0,1,2
9305,0,0,1,0,1,2
9306,0,0,0,2,0,2
9307,0,0,0,2,0,2
9308,0,0,0,2,0,2
9309,0,0,0,2,0,2
9310,0,0,0,2,0,2
9311,0,0,0,2,0,2
9312,0,0,0,2,0,2
9313,0,0,0,2,0,2
9314,0,0,0,2,0,2
9315,0,0,0,2,0,2
9316,0,0,0,2,0,2
9317,0,0,0,2,0,2
9318,0,0,0,2,0,2
9319,0,0,0,2,0,2
9320,0,0,0,2,0,2
9321,0,0,0,2,0,2
9322,0,0,0,2,0,2
9323,0,0,0,2,0,2
9324,0,0,0,2,0,2
9325,0,0,0,2,0,2
9326,0,0,0,2,0,2
9327,0,0,0,2,0,2
9328,0,0,0,2,0,2
9329,0,0,0,2,0,2
9330,0,0,0,2,0,2
9331,0,0,0,2,0,2
9332,0,0,0,2,0,2
9333,0,0,0,2,0,2
9334,0,0,0,2,0,2
9335,0,0,0,2,0,2
9336,0,0,0,2,0,2
9337,0,0,0,2,0,2
9338,0,0,0,2,0,2
9339,0,0,0,2,0,2
9340,0,0,0,2,0,2
9341,0,0,0,2,0,2
9342,0,0,0,2,0,2
9343,0,0,0,2,0,2
9344,0,0,0,2,0,2
9345,0,0,0,2,0,2
9346,0,0,0,2,0,2
9347,0,0,0,2,0,2
9348,0,0,0,2,0,2
9349,0,0,0,2,0,2
9350,0,0,0,2,0,2
9351,0,0,0,0,2,2
9352,0,0,0,1,1,2
9353,0,0,0,0,2,2
9354,0,0,0,1,1,2
9355,0,0,0,1,1,2
9356,0,0,0,1,1,2
9357,0,0,0,0,2,2
9358,0,0,0,0,2,2
9359,0,0,0,0,2,2
9360,0,0,0,0,2,2
9361,0,0,0,0,2,2
9362,0,0,0,0,2,2
9363,0,0,0,0,2,2
9364,0,0,0,0,2,2
9365,0,0,0,0,2,2
9366,0,0,0,0,2,2
9367,0,0,0,0,2,2
9368,0,0,0,0,2,2
9369,0,0,0,0,2,2
9370,0,0,0,0,2,2
9371,0,0,0,0,2,2
9372,0,0,0,0,2,2
9373,0,0,0,0,2,2
9374,0,0,0,0,2,2
9375,0,0,0,0,2,2
9376,0,0,0,0,2,2
9377,0,0,0,0,2,2
9378,0,0,0,0,2,2
9379,0,0,0,0,2,2
9380,0,0,0,0,2,2
9381,0,0,0,0,2,2
9382,0,0,0,0,2,2
9383,0,0,0,0,2,2
9384,0,0,0,0,2,2
9385,0,0,0,0,2,2
9386,0,0,0,0,2,2
9387,0,0,0,0,2,2
9388,0,0,0,0,2,2
9389,0,0,0,0,2,2
9390,0,0,0,0,2,2
9391,0,0,0,0,2,2
9392,0,0,0,0,2,2
9393,0,0,0,0,2,2
9394,0,0,0,0,2,2
9395,0,0,0,0,2,2
9396,0,0,0,0,2,2
9397,0,0,0,0,2,2
9398,0,0,0,0,2,2
9399,0,0,0,0,2,2
9400,0,0,0,0,2,2
9401,0,0,0,0,2,2
9402,0,0,0,0,2,2
9403,0,0,0,0,2,2
9404,0,0,0,0,2,2
9405,0,0,0,0,2,2
9406,0,0,0,0,2,2
9407,0,0,0,0,2,2
9408,0,0,0,0,2,2
9409,0,0,0,0,2,2
9410,0,0,0,0,2,2
9411,0,0,0,0,2,2
9412,0,0,0,0,2,2
9413,0,0,0,0,2,2
9414,0,0,0,0,2,2
9415,0,0,0,0,2,2
9416,0,0,0,0,2,2
9417,0,0,0,0,2,2
9418,0,0,0,0,2,2
9419,0,0,0,0,2,2
9420,0,0,0,0,2,2
9421,0,0,0,0,2,2
9422,0,0,0,0,2,2
9423,0,0,0,0,2,2
9424,0,0,0,0,2,2
9425,0,0,0,0,2,2
9426,0,0,0,0,2,2
9427,0,0,0,0,2,2
9428,0,0,0,0,2,2
9429,0,0,0,0,2,2
9430,0,1,0,0,0,1
9431,0,1,0,0,0,1
9432,0,1,0,0,0,1
9433,1,0,0,0,0,1
9434,1,0,0,0,0,1
9435,1,0,0,0,0,1
9436,0,1,0,0,0,1
9437,0,1,0,0,0,1
9438,1,0,0,0,0,1
9439,1,0,0,0,0,1
9440,1,0,0,0,0,1
9441,1,0,0,0,0,1
9442,0,1,0,0,0,1
9443,1,0,0,0,0,1
9444,1,0,0,0,0,1
9445,1,0,0,0,0,1
9446,1,0,0,0,0,1
9447,1,0,0,0,0,1
9448,0,1,0,0,0,1
9449,1,0,0,0,0,1
9450,0,1,0,0,0,1
9451,1,0,0,0,0,1
9452,0,1,0,0,0,1
9453,1,0,0,0,0,1
9454,0,1,0,0,0,1
9455,0,1,0,0,0,1
9456,0,1,0,0,0,1
9457,0,1,0,0,0,1
9458,0,1,0,0,0,1
9459,0,1,0,0,0,1
9460,1,0,0,0,0,1
9461,1,0,0,0,0,1
9462,1,0,0,0,0,1
9463,0,0,1,0,0,1
9464,1,0,0,0,0,1
9465,1,0,0,0,0,1
9466,1,0,0,0,0,1
9467,0,1,0,0,0,1
9468,1,0,0,0,0,1
9469,0,1,0,0,0,1
9470,0,0,0,0,1,1
9471,1,0,0,0,0,1
9472,1,0,0,0,0,1
9473,1,0,0,0,0,1
9474,0,0,1,0,0,1
9475,0,0,1,0,0,1
9476,1,0,0,0,0,1
9477,1,0,0,0,0,1
9478,0,1,0,0,0,1
9479,0,1,0,0,0,1
9480,0,1,0,0,0,1
9481,1,0,0,0,0,1
9482,1,0,0,0,0,1
9483,1,0,0,0,0,1
9484,1,0,0,0,0,1
9485,0,1,0,0,0,1
9486,0,1,0,0,0,1
9487,0,1,0,0,0,1
9488,0,1,0,0,0,1
9489,0,0,0,0,1,1
9490,0,1,0,0,0,1
9491,0,1,0,0,0,1
9492,0,1,0,0,0,1
9493,0,0,0,0,1,1
9494,0,1,0,0,0,1
9495,0,1,0,0,0,1
9496,0,1,0,0,0,1
9497,0,1,0,0,0,1
9498,1,0,0,0,0,1
9499,0,0,0,0,1,1
9500,0,1,0,0,0,1
9501,0,1,0,0,0,1
9502,0,1,0,0,0,1
9503,0,1,0,0,0,1
9504,0,1,0,0,0,1
9505,1,0,0,0,0,1
9506,1,0,0,0,0,1
9507,1,0,0,0,0,1
9508,1,0,0,0,0,1
9509,1,0,0,0,0,1
9510,1,0,0,0,0,1
9511,0,1,0,0,0,1
9512,0,1,0,0,0,1
9513,0,0,0,0,1,1
9514,0,1,0,0,0,1
9515,0,1,0,0,0,1
9516,0,1,0,0,0,1
9517,1,0,0,0,0,1
9518,1,0,0,0,0,1
9519,1,0,0,0,0,1
9520,1,0,0,0,0,1
9521,1,0,0,0,0,1
9522,1,0,0,0,0,1
9523,0,1,0,0,0,1
9524,0,1,0,0,0,1
9525,0,1,0,0,0,1
9526,0,0,0,0,1,1
9527,0,1,0,0,0,1
9528,0,1,0,0,0,1
9529,0,1,0,0,0,1
9530,0,1,0,0,0,1
9531,0,1,0,0,0,1
9532,0,1,0,0,0,1
9533,0,1,0,0,0,1
9534,0,1,0,0,0,1
9535,0,1,0,0,0,1
9536,0,1,0,0,0,1
9537,0,1,0,0,0,1
9538,0,1,0,0,0,1
9539,0,1,0,0,0,1
9540,0,1,0,0,0,1
9541,0,1,0,0,0,1
9542,0,1,0,0,0,1
9543,0,1,0,0,0,1
9544,0,1,0,0,0,1
9545,0,1,0,0,0,1
9546,1,0,0,0,0,1
9547,0,1,0,0,0,1
9548,1,0,0,0,0,1
9549,1,0,0,0,0,1
9550,0,0,0,0,1,1
9551,1,0,0,0,0,1
9552,1,0,0,0,0,1
9553,0,0,0,0,1,1
9554,1,0,0,0,0,1
9555,0,0,0,0,1,1
9556,0,0,0,0,1,1
9557,0,1,0,0,0,1
9558,1,0,0,0,0,1
9559,1,0,0,0,0,1
9560,0,1,0,0,0,1
9561,1,0,0,0,0,1
9562,1,0,0,0,0,1
9563,0,0,0,0,1,1
9564,0,0,0,0,1,1
9565,1,0,0,0,0,1
9566,0,1,0,0,0,1
9567,0,0,0,0,1,1
9568,0,1,0,0,0,1
9569,0,1,0,0,0,1
9570,0,1,0,0,0,1
9571,0,1,0,0,0,1
9572,0,1,0,0,0,1
9573,0,1,0,0,0,1
9574,0,1,0,0,0,1
9575,0,1,0,0,0,1
9576,1,0,0,0,0,1
9577,0,1,0,0,0,1
9578,1,0,0,0,0,1
9579,0,1,0,0,0,1
9580,0,1,0,0,0,1
9581,0,1,0,0,0,1
9582,0,1,0,0,0,1
9583,1,0,0,0,0,1
9584,0,0,0,0,1,1
9585,1,0,0,0,0,1
9586,1,0,0,0,0,1
9587,0,1,0,0,0,1
9588,0,1,0,0,0,1
9589,0,0,0,0,1,1
9590,0,1,0,0,0,1
9591,0,1,0,0,0,1
9592,1,0,0,0,0,1
9593,0,0,0,0,1,1
9594,0,0,0,0,1,1
9595,0,0,0,0,1,1
9596,0,1,0,0,0,1
9597,0,1,0,0,0,1
9598,0,1,0,0,0,1
9599,0,1,0,0,0,1
9600,0,1,0,0,0,1
9601,0,0,1,0,0,1
9602,0,1,0,0,0,1
9603,1,0,0,0,0,1
9604,0,1,0,0,0,1
9605,0,1,0,0,0,1
9606,1,0,0,0,0,1
9607,0,1,0,0,0,1
9608,0,1,0,0,0,1
9609,0,1,0,0,0,1
9610,1,0,0,0,0,1
9611,1,0,0,0,0,1
9612,0,1,0,0,0,1
9613,0,1,0,0,0,1
9614,0,1,0,0,0,1
9615,0,0,1,0,0,1
9616,0,0,1,0,0,1
9617,0,0,1,0,0,1
9618,0,0,1,0,0,1
9619,0,1,0,0,0,1
9620,0,1,0,0,0,1
9621,0,1,0,0,0,1
9622,1,0,0,0,0,1
9623,0,1,0,0,0,1
9624,0,0,0,0,1,1
9625,1,0,0,0,0,1
9626,0,0,0,0,1,1
9627,1,0,0,0,0,1
9628,0,1,0,0,0,1
9629,0,0,0,0,1,1
9630,0,1,0,0,0,1
9631,0,0,0,0,1,1
9632,0,0,0,0,1,1
9633,0,1,0,0,0,1
9634,0,0,0,0,1,1
9635,1,0,0,0,0,1
9636,0,1,0,0,0,1
9637,0,0,0,0,1,1
9638,1,0,0,0,0,1
9639,0,0,0,0,1,1
9640,0,0,1,0,0,1
9641,0,1,0,0,0,1
9642,1,0,0,0,0,1
9643,1,0,0,0,0,1
9644,0,1,0,0,0,1
9645,1,0,0,0,0,1
9646,0,0,1,0,0,1
9647,1,0,0,0,0,1
9648,1,0,0,0,0,1
9649,0,1,0,0,0,1
9650,0,0,0,0,1,1
9651,0,1,0,0,0,1
9652,0,1,0,0,0,1
9653,0,1,0,0,0,1
9654,0,1,0,0,0,1
9655,0,0,1,0,0,1
9656,0,1,0,0,0,1
9657,0,0,1,0,0,1
9658,0,0,0,0,1,1
9659,0,0,0,0,1,1
9660,0,0,0,0,1,1
9661,1,0,0,0,0,1
9662,1,0,0,0,0,1
9663,0,0,0,0,1,1
9664,1,0,0,0,0,1
9665,0,1,0,0,0,1
9666,0,1,0,0,0,1
9667,0,1,0,0,0,1
9668,0,1,0,0,0,1
9669,0,1,0,0,0,1
9670,0,1,0,0,0,1
9671,0,1,0,0,0,1
9672,0,0,0,0,1,1
9673,0,1,0,0,0,1
9674,1,0,0,0,0,1
9675,0,0,0,0,1,1
9676,0,0,0,0,1,1
9677,1,0,0,0,0,1
9678,0,0,0,0,1,1
9679,0,0,0,0,1,1
9680,0,0,0,1,0,1
9681,0,0,0,1,0,1
9682,0,0,0,1,0,1
9683,0,0,0,1,0,1
9684,0,0,0,1,0,1
9685,0,1,0,0,0,1
9686,0,1,0,0,0,1
9687,0,0,1,0,0,1
9688,0,1,0,0,0,1
9689,0,0,0,0,1,1
9690,1,0,0,0,0,1
9691,1,0,0,0,0,1
9692,1,0,0,0,0,1
9693,1,0,0,0,0,1
9694,1,0,0,0,0,1
9695,0,1,0,0,0,1
9696,1,0,0,0,0,1
9697,1,0,0,0,0,1
9698,0,1,0,0,0,1
9699,1,0,0,0,0,1
9700,0,1,0,0,0,1
9701,1,0,0,0,0,1
9702,1,0,0,0,0,1
9703,1,0,0,0,0,1
9704,1,0,0,0,0,1
9705,0,0,1,0,0,1
9706,1,0,0,0,0,1
9707,1,0,0,0,0,1
9708,0,1,0,0,0,1
9709,0,1,0,0,0,1
9710,0,1,0,0,0,1
9711,1,0,0,0,0,1
9712,0,1,0,0,0,1
9713,0,0,1,0,0,1
9714,1,0,0,0,0,1
9715,0,0,0,1,0,1
9716,0,1,0,0,0,1
9717,0,1,0,0,0,1
9718,0,1,0,0,0,1
9719,0,1,0,0,0,1
9720,0,1,0,0,0,1
9721,0,1,0,0,0,1
9722,1,0,0,0,0,1
9723,0,1,0,0,0,1
9724,1,0,0,0,0,1
9725,0,1,0,0,0,1
9726,1,0,0,0,0,1
9727,0,1,0,0,0,1
9728,1,0,0,0,0,1
9729,0,1,0,0,0,1
9730,0,1,0,0,0,1
9731,0,0,0,0,1,1
9732,1,0,0,0,0,1
9733,1,0,0,0,0,1
9734,0,0,0,0,1,1
9735,1,0,0,0,0,1
9736,1,0,0,0,0,1
9737,0,0,1,0,0,1
9738,1,0,0,0,0,1
9739,0,0,0,0,1,1
9740,0,0,1,0,0,1
9741,1,0,0,0,0,1
9742,1,0,0,0,0,1
9743,0,1,0,0,0,1
9744,1,0,0,0,0,1
9745,0,1,0,0,0,1
9746,0,1,0,0,0,1
9747,0,1,0,0,0,1
9748,1,0,0,0,0,1
9749,0,1,0,0,0,1
9750,0,1,0,0,0,1
9751,0,1,0,0,0,1
9752,1,0,0,0,0,1
9753,1,0,0,0,0,1
9754,0,1,0,0,0,1
9755,0,1,0,0,0,1
9756,0,1,0,0,0,1
9757,1,0,0,0,0,1
9758,0,1,0,0,0,1
9759,0,1,0,0,0,1
9760,0,1,0,0,0,1
9761,0,1,0,0,0,1
9762,0,1,0,0,0,1
9763,0,1,0,0,0,1
9764,0,1,0,0,0,1
9765,0,1,0,0,0,1
9766,1,0,0,0,0,1
9767,0,1,0,0,0,1
9768,0,1,0,0,0,1
9769,1,0,0,0,0,1
9770,1,0,0,0,0,1
9771,1,0,0,0,0,1
9772,1,0,0,0,0,1
9773,1,0,0,0,0,1
9774,0,1,0,0,0,1
9775,0,1,0,0,0,1
9776,1,0,0,0,0,1
9777,1,0,0,0,0,1
9778,1,0,0,0,0,1
9779,1,0,0,0,0,1
9780,1,0,0,0,0,1
9781,0,1,0,0,0,1
9782,0,1,0,0,0,1
9783,1,0,0,0,0,1
9784,1,0,0,0,0,1
9785,0,0,0,0,1,1
9786,0,1,0,0,0,1
9787,1,0,0,0,0,1
9788,1,0,0,0,0,1
9789,1,0,0,0,0,1
9790,0,1,0,0,0,1
9791,0,1,0,0,0,1
9792,0,0,1,0,0,1
9793,1,0,0,0,0,1
9794,1,0,0,0,0,1
9795,0,1,0,0,0,1
9796,0,0,1,0,0,1
9797,1,0,0,0,0,1
9798,1,0,0,0,0,1
9799,0,1,0,0,0,1
9800,0,1,0,0,0,1
9801,1,0,0,0,0,1
9802,1,0,0,0,0,1
9803,0,0,0,0,1,1
9804,0,1,0,0,0,1
9805,0,1,0,0,0,1
9806,1,0,0,0,0,1
9807,0,1,0,0,0,1
9808,0,1,0,0,0,1
9809,0,0,1,0,0,1
9810,0,1,0,0,0,1
9811,0,1,0,0,0,1
9812,0,1,0,0,0,1
9813,0,1,0,0,0,1
9814,1,0,0,0,0,1
9815,1,0,0,0,0,1
9816,1,0,0,0,0,1
9817,0,1,0,0,0,1
9818,0,1,0,0,0,1
9819,0,0,0,0,1,1
9820,0,0,0,0,1,1
9821,0,1,0,0,0,1
9822,0,1,0,0,0,1
9823,0,1,0,0,0,1
9824,0,1,0,0,0,1
9825,0,1,0,0,0,1
9826,0,1,0,0,0,1
9827,0,0,0,0,1,1
9828,1,0,0,0,0,1
9829,0,1,0,0,0,1
9830,0,1,0,0,0,1
9831,0,1,0,0,0,1
9832,1,0,0,0,0,1
9833,0,1,0,0,0,1
9834,0,1,0,0,0,1
9835,0,1,0,0,0,1
9836,0,1,0,0,0,1
9837,0,1,0,0,0,1
9838,0,1,0,0,0,1
9839,1,0,0,0,0,1
9840,1,0,0,0,0,1
9841,1,0,0,0,0,1
9842,1,0,0,0,0,1
9843,1,0,0,0,0,1
9844,0,1,0,0,0,1
9845,0,1,0,0,0,1
9846,0,1,0,0,0,1
9847,0,1,0,0,0,1
9848,1,0,0,0,0,1
9849,1,0,0,0,0,1
9850,1,0,0,0,0,1
9851,0,1,0,0,0,1
9852,0,1,0,0,0,1
9853,1,0,0,0,0,1
9854,0,0,1,0,0,1
9855,0,0,1,0,0,1
9856,1,0,0,0,0,1
9857,1,0,0,0,0,1
9858,1,0,0,0,0,1
9859,0,1,0,0,0,1
9860,1,0,0,0,0,1
9861,0,1,0,0,0,1
9862,0,1,0,0,0,1
9863,0,1,0,0,0,1
9864,0,1,0,0,0,1
9865,0,1,0,0,0,1
9866,1,0,0,0,0,1
9867,0,1,0,0,0,1
9868,0,1,0,0,0,1
9869,1,0,0,0,0,1
9870,1,0,0,0,0,1
9871,0,1,0,0,0,1
9872,0,0,0,0,1,1
9873,0,1,0,0,0,1
9874,0,1,0,0,0,1
9875,0,0,0,0,1,1
9876,0,1,0,0,0,1
9877,1,0,0,0,0,1
9878,0,1,0,0,0,1
9879,1,0,0,0,0,1
9880,1,0,0,0,0,1
9881,1,0,0,0,0,1
9882,0,1,0,0,0,1
9883,1,0,0,0,0,1
9884,1,0,0,0,0,1
9885,1,0,0,0,0,1
9886,1,0,0,0,0,1
9887,1,0,0,0,0,1
9888,0,0,0,1,0,1
9889,0,1,0,0,0,1
9890,0,1,0,0,0,1
9891,0,1,0,0,0,1
9892,1,0,0,0,0,1
9893,1,0,0,0,0,1
9894,0,0,0,1,0,1
9895,0,1,0,0,0,1
9896,0,0,0,1,0,1
9897,0,0,0,1,0,1
9898,0,0,1,0,0,1
9899,0,1,0,0,0,1
9900,0,1,0,0,0,1
9901,0,1,0,0,0,1
9902,0,1,0,0,0,1
9903,0,0,0,1,0,1
9904,0,0,0,1,0,1
9905,0,1,0,0,0,1
9906,0,1,0,0,0,1
9907,1,0,0,0,0,1
9908,0,1,0,0,0,1
9909,1,0,0,0,0,1
9910,1,0,0,0,0,1
9911,0,1,0,0,0,1
9912,0,0,1,0,0,1
9913,0,0,1,0,0,1
9914,0,1,0,0,0,1
9915,0,1,0,0,0,1
9916,0,1,0,0,0,1
9917,1,0,0,0,0,1
9918,1,0,0,0,0,1
9919,0,1,0,0,0,1
9920,0,0,0,1,0,1
9921,0,0,0,1,0,1
9922,0,0,0,0,1,1
9923,1,0,0,0,0,1
9924,0,1,0,0,0,1
9925,0,1,0,0,0,1
9926,0,1,0,0,0,1
9927,0,0,0,1,0,1
9928,0,1,0,0,0,1
9929,0,0,0,1,0,1
9930,0,1,0,0,0,1
9931,0,1,0,0,0,1
9932,0,1,0,0,0,1
9933,0,1,0,0,0,1
9934,0,1,0,0,0,1
9935,0,1,0,0,0,1
9936,0,0,0,0,1,1
9937,0,1,0,0,0,1
9938,0,1,0,0,0,1
9939,1,0,0,0,0,1
9940,0,1,0,0,0,1
9941,0,0,1,0,0,1
9942,0,0,1,0,0,1
9943,0,1,0,0,0,1
9944,0,1,0,0,0,1
9945,0,1,0,0,0,1
9946,0,1,0,0,0,1
9947,1,0,0,0,0,1
9948,0,0,0,0,1,1
9949,0,0,1,0,0,1
9950,0,0,0,0,1,1
9951,0,1,0,0,0,1
9952,0,1,0,0,0,1
9953,0,0,0,0,1,1
9954,0,1,0,0,0,1
9955,0,1,0,0,0,1
9956,0,0,0,1,0,1
9957,1,0,0,0,0,1
9958,0,0,0,1,0,1
9959,0,0,0,1,0,1
9960,0,0,0,1,0,1
9961,0,0,0,1,0,1
9962,0,1,0,0,0,1
9963,0,0,0,1,0,1
9964,0,1,0,0,0,1
9965,0,0,0,1,0,1
9966,0,1,0,0,0,1
9967,0,1,0,0,0,1
9968,0,0,0,1,0,1
9969,0,0,0,1,0,1
9970,0,0,1,0,0,1
9971,0,1,0,0,0,1
9972,0,1,0,0,0,1
9973,0,0,0,1,0,1
9974,0,0,0,0,1,1
9975,0,1,0,0,0,1
9976,0,1,0,0,0,1
9977,1,0,0,0,0,1
9978,0,1,0,0,0,1
9979,1,0,0,0,0,1
9980,0,1,0,0,0,1
9981,0,1,0,0,0,1
9982,0,1,0,0,0,1
9983,0,1,0,0,0,1
9984,0,1,0,0,0,1
9985,0,0,0,1,0,1
9986,0,0,0,1,0,1
9987,0,0,0,1,0,1
9988,0,1,0,0,0,1
9989,0,0,0,0,1,1
9990,1,0,0,0,0,1
9991,0,1,0,0,0,1
9992,0,0,0,0,1,1
9993,0,1,0,0,0,1
9994,0,1,0,0,0,1
9995,1,0,0,0,0,1
9996,1,0,0,0,0,1
9997,1,0,0,0,0,1
9998,1,0,0,0,0,1
9999,0,1,0,0,0,1
10000,0,1,0,0,0,1
10001,0,1,0,0,0,1
10002,0,1,0,0,0,1
10003,0,1,0,0,0,1
10004,0,1,0,0,0,1
10005,0,1,0,0,0,1
10006,0,1,0,0,0,1
10007,1,0,0,0,0,1
10008,1,0,0,0,0,1
10009,0,0,0,1,0,1
10010,0,1,0,0,0,1
10011,0,1,0,0,0,1
10012,1,0,0,0,0,1
10013,0,1,0,0,0,1
10014,0,0,0,1,0,1
10015,0,0,0,1,0,1
10016,0,1,0,0,0,1
10017,0,1,0,0,0,1
10018,0,1,0,0,0,1
10019,0,1,0,0,0,1
10020,0,0,0,1,0,1
10021,0,0,0,1,0,1
10022,0,0,0,1,0,1
10023,0,1,0,0,0,1
10024,0,1,0,0,0,1
10025,0,0,0,1,0,1
10026,0,1,0,0,0,1
10027,0,1,0,0,0,1
10028,0,1,0,0,0,1
10029,1,0,0,0,0,1
10030,0,1,0,0,0,1
10031,0,1,0,0,0,1
10032,0,0,0,1,0,1
10033,0,0,0,1,0,1
10034,0,1,0,0,0,1
10035,0,1,0,0,0,1
10036,0,0,0,0,1,1
10037,0,0,0,1,0,1
10038,0,0,0,0,1,1
10039,1,0,0,0,0,1
10040,1,0,0,0,0,1
10041,0,0,0,0,1,1
10042,0,0,0,0,1,1
10043,0,0,0,0,1,1
10044,0,0,0,0,1,1
10045,0,0,0,0,1,1
10046,0,0,0,0,1,1
10047,0,0,0,0,1,1
10048,0,0,0,0,1,1
10049,0,0,0,0,1,1
10050,1,0,0,0,0,1
10051,0,0,0,0,1,1
10052,1,0,0,0,0,1
10053,1,0,0,0,0,1
10054,0,1,0,0,0,1
10055,0,1,0,0,0,1
10056,0,0,0,0,1,1
10057,0,1,0,0,0,1
10058,0,1,0,0,0,1
10059,1,0,0,0,0,1
10060,0,0,0,1,0,1
10061,0,0,0,1,0,1
10062,0,0,1,0,0,1
10063,0,0,1,0,0,1
10064,0,0,1,0,0,1
10065,0,1,0,0,0,1
10066,0,1,0,0,0,1
10067,0,1,0,0,0,1
10068,0,1,0,0,0,1
10069,0,1,0,0,0,1
10070,0,1,0,0,0,1
10071,0,1,0,0,0,1
10072,1,0,0,0,0,1
10073,0,1,0,0,0,1
10074,0,1,0,0,0,1
10075,1,0,0,0,0,1
10076,0,1,0,0,0,1
10077,0,0,1,0,0,1
10078,1,0,0,0,0,1
10079,1,0,0,0,0,1
10080,1,0,0,0,0,1
10081,0,0,0,0,1,1
10082,1,0,0,0,0,1
10083,1,0,0,0,0,1
10084,0,0,0,1,0,1
10085,0,1,0,0,0,1
10086,0,1,0,0,0,1
10087,1,0,0,0,0,1
10088,1,0,0,0,0,1
10089,0,1,0,0,0,1
10090,0,0,0,1,0,1
10091,0,0,0,1,0,1
10092,0,0,0,0,1,1
10093,0,1,0,0,0,1
10094,0,0,0,1,0,1
10095,0,0,0,0,1,1
10096,0,0,0,0,1,1
10097,0,1,0,0,0,1
10098,0,0,0,0,1,1
10099,0,1,0,0,0,1
10100,1,0,0,0,0,1
10101,0,0,0,0,1,1
10102,0,0,0,0,1,1
10103,0,0,0,0,1,1
10104,1,0,0,0,0,1
10105,1,0,0,0,0,1
10106,0,0,0,0,1,1
10107,0,0,0,0,1,1
10108,0,0,0,0,1,1
10109,0,0,0,0,1,1
10110,0,1,0,0,0,1
10111,0,0,0,0,1,1
10112,0,1,0,0,0,1
10113,1,0,0,0,0,1
10114,0,0,0,0,1,1
10115,0,0,0,0,1,1
10116,0,0,0,1,0,1
10117,0,1,0,0,0,1
10118,1,0,0,0,0,1
10119,0,1,0,0,0,1
10120,0,0,0,0,1,1
10121,0,1,0,0,0,1
10122,0,0,0,0,1,1
10123,0,1,0,0,0,1
10124,0,1,0,0,0,1
10125,0,0,0,0,1,1
10126,0,1,0,0,0,1
10127,0,1,0,0,0,1
10128,0,1,0,0,0,1
10129,0,0,0,1,0,1
10130,0,1,0,0,0,1
10131,1,0,0,0,0,1
10132,0,1,0,0,0,1
10133,0,1,0,0,0,1
10134,0,1,0,0,0,1
10135,0,1,0,0,0,1
10136,0,0,0,1,0,1
10137,0,1,0,0,0,1
10138,0,1,0,0,0,1
10139,0,1,0,0,0,1
10140,0,1,0,0,0,1
10141,0,1,0,0,0,1
10142,1,0,0,0,0,1
10143,0,1,0,0,0,1
10144,1,0,0,0,0,1
10145,0,0,0,0,1,1
10146,0,0,1,0,0,1
10147,0,0,1,0,0,1
10148,1,0,0,0,0,1
10149,1,0,0,0,0,1
10150,0,0,1,0,0,1
10151,0,0,1,0,0,1
10152,0,0,1,0,0,1
10153,0,0,1,0,0,1
10154,0,0,0,1,0,1
10155,1,0,0,0,0,1
10156,0,0,0,0,1,1
10157,1,0,0,0,0,1
10158,0,0,0,0,1,1
10159,0,0,0,0,1,1
10160,0,0,0,0,1,1
10161,0,1,0,0,0,1
10162,0,0,0,0,1,1
10163,1,0,0,0,0,1
10164,0,1,0,0,0,1
10165,0,0,0,0,1,1
10166,1,0,0,0,0,1
10167,0,0,0,0,1,1
10168,0,0,0,0,1,1
10169,0,0,0,0,1,1
10170,0,0,0,0,1,1
10171,1,0,0,0,0,1
10172,1,0,0,0,0,1
10173,0,1,0,0,0,1
10174,0,0,0,0,1,1
10175,0,0,0,0,1,1
10176,0,0,0,0,1,1
10177,0,0,0,0,1,1
10178,1,0,0,0,0,1
10179,0,1,0,0,0,1
10180,0,0,0,0,1,1
10181,0,0,0,0,1,1
10182,1,0,0,0,0,1
10183,1,0,0,0,0,1
10184,0,1,0,0,0,1
10185,0,0,0,0,1,1
10186,0,0,0,0,1,1
10187,0,0,0,0,1,1
10188,0,0,0,0,1,1
10189,0,0,0,0,1,1
10190,0,0,0,0,1,1
10191,0,1,0,0,0,1
10192,0,1,0,0,0,1
10193,0,0,0,1,0,1
10194,0,0,0,0,1,1
10195,0,1,0,0,0,1
10196,0,1,0,0,0,1
10197,0,1,0,0,0,1
10198,0,0,0,1,0,1
10199,0,0,0,0,1,1
10200,0,0,0,0,1,1
10201,0,1,0,0,0,1
10202,0,1,0,0,0,1
10203,0,1,0,0,0,1
10204,0,1,0,0,0,1
10205,0,1,0,0,0,1
10206,0,1,0,0,0,1
10207,0,0,0,1,0,1
10208,0,0,0,1,0,1
10209,0,1,0,0,0,1
10210,0,1,0,0,0,1
10211,0,1,0,0,0,1
10212,0,1,0,0,0,1
10213,0,0,0,1,0,1
10214,0,0,0,1,0,1
10215,0,1,0,0,0,1
10216,0,1,0,0,0,1
10217,0,1,0,0,0,1
10218,1,0,0,0,0,1
10219,0,1,0,0,0,1
10220,0,0,0,1,0,1
10221,0,0,0,1,0,1
10222,0,1,0,0,0,1
10223,0,1,0,0,0,1
10224,0,1,0,0,0,1
10225,1,0,0,0,0,1
10226,0,1,0,0,0,1
10227,1,0,0,0,0,1
10228,0,0,1,0,0,1
10229,0,0,1,0,0,1
10230,0,0,1,0,0,1
10231,0,0,1,0,0,1
10232,0,0,1,0,0,1
10233,0,0,1,0,0,1
10234,1,0,0,0,0,1
10235,0,0,1,0,0,1
10236,0,0,1,0,0,1
10237,0,0,1,0,0,1
10238,0,1,0,0,0,1
10239,0,0,0,1,0,1
10240,0,1,0,0,0,1
10241,0,0,0,0,1,1
10242,0,0,0,0,1,1
10243,0,0,0,0,1,1
10244,0,0,0,0,1,1
10245,0,0,0,0,1,1
10246,0,0,0,0,1,1
10247,0,0,0,0,1,1
10248,0,0,0,0,1,1
10249,0,0,0,0,1,1
10250,0,0,0,0,1,1
10251,1,0,0,0,0,1
10252,0,1,0,0,0,1
10253,0,0,0,0,1,1
10254,0,0,0,0,1,1
10255,0,1,0,0,0,1
10256,0,0,0,0,1,1
10257,1,0,0,0,0,1
10258,0,0,0,0,1,1
10259,0,1,0,0,0,1
10260,0,1,0,0,0,1
10261,0,0,0,0,1,1
10262,0,0,0,0,1,1
10263,0,1,0,0,0,1
10264,0,0,0,0,1,1
10265,0,1,0,0,0,1
10266,0,0,0,0,1,1
10267,0,1,0,0,0,1
10268,0,0,0,0,1,1
10269,0,0,0,0,1,1
10270,0,1,0,0,0,1
10271,0,0,0,0,1,1
10272,0,0,0,0,1,1
10273,0,1,0,0,0,1
10274,0,0,0,0,1,1
10275,0,1,0,0,0,1
10276,0,1,0,0,0,1
10277,0,0,0,1,0,1
10278,0,1,0,0,0,1
10279,0,1,0,0,0,1
10280,0,1,0,0,0,1
10281,0,0,0,1,0,1
10282,1,0,0,0,0,1
10283,0,0,0,1,0,1
10284,0,0,0,1,0,1
10285,1,0,0,0,0,1
10286,0,1,0,0,0,1
10287,0,1,0,0,0,1
10288,1,0,0,0,0,1
10289,0,1,0,0,0,1
10290,1,0,0,0,0,1
10291,1,0,0,0,0,1
10292,0,1,0,0,0,1
10293,1,0,0,0,0,1
10294,1,0,0,0,0,1
10295,0,1,0,0,0,1
10296,0,0,0,1,0,1
10297,0,0,0,0,1,1
10298,0,1,0,0,0,1
10299,0,0,0,1,0,1
10300,0,1,0,0,0,1
10301,1,0,0,0,0,1
10302,0,0,0,1,0,1
10303,0,1,0,0,0,1
10304,1,0,0,0,0,1
10305,1,0,0,0,0,1
10306,0,0,0,0,1,1
10307,0,0,0,0,1,1
10308,0,0,0,0,1,1
10309,1,0,0,0,0,1
10310,1,0,0,0,0,1
10311,0,0,0,0,1,1
10312,0,0,0,0,1,1
10313,0,0,0,0,1,1
10314,0,0,0,0,1,1
10315,0,0,0,0,1,1
10316,1,0,0,0,0,1
10317,0,0,0,0,1,1
10318,0,1,0,0,0,1
10319,0,1,0,0,0,1
10320,0,1,0,0,0,1
10321,0,1,0,0,0,1
10322,0,1,0,0,0,1
10323,0,1,0,0,0,1
10324,0,1,0,0,0,1
10325,0,0,0,0,1,1
10326,0,1,0,0,0,1
10327,0,1,0,0,0,1
10328,0,0,0,0,1,1
10329,0,1,0,0,0,1
10330,1,0,0,0,0,1
10331,0,1,0,0,0,1
10332,0,1,0,0,0,1
10333,0,1,0,0,0,1
10334,0,0,0,0,1,1
10335,0,0,0,0,1,1
10336,0,1,0,0,0,1
10337,0,0,0,1,0,1
10338,0,0,0,1,0,1
10339,0,1,0,0,0,1
10340,0,1,0,0,0,1
10341,0,1,0,0,0,1
10342,0,0,0,1,0,1
10343,0,0,0,1,0,1
10344,0,0,0,0,1,1
10345,0,0,0,0,1,1
10346,0,1,0,0,0,1
10347,0,1,0,0,0,1
10348,0,1,0,0,0,1
10349,0,1,0,0,0,1
10350,0,1,0,0,0,1
10351,0,1,0,0,0,1
10352,0,1,0,0,0,1
10353,0,1,0,0,0,1
10354,0,1,0,0,0,1
10355,0,0,0,1,0,1
10356,1,0,0,0,0,1
10357,0,0,0,1,0,1
10358,1,0,0,0,0,1
10359,0,0,0,1,0,1
10360,1,0,0,0,0,1
10361,1,0,0,0,0,1
10362,0,0,0,1,0,1
10363,0,0,0,1,0,1
10364,0,0,0,1,0,1
10365,0,0,0,1,0,1
10366,0,1,0,0,0,1
10367,0,0,0,0,1,1
10368,1,0,0,0,0,1
10369,0,1,0,0,0,1
10370,0,1,0,0,0,1
10371,1,0,0,0,0,1
10372,1,0,0,0,0,1
10373,0,1,0,0,0,1
10374,1,0,0,0,0,1
10375,0,1,0,0,0,1
10376,0,0,0,0,1,1
10377,1,0,0,0,0,1
10378,0,1,0,0,0,1
10379,0,1,0,0,0,1
10380,0,1,0,0,0,1
10381,1,0,0,0,0,1
10382,0,1,0,0,0,1
10383,0,1,0,0,0,1
10384,0,1,0,0,0,1
10385,0,0,0,0,1,1
10386,1,0,0,0,0,1
10387,0,1,0,0,0,1
10388,1,0,0,0,0,1
10389,0,1,0,0,0,1
10390,0,0,0,0,1,1
10391,0,1,0,0,0,1
10392,1,0,0,0,0,1
10393,0,1,0,0,0,1
10394,0,1,0,0,0,1
10395,0,1,0,0,0,1
10396,0,0,1,0,0,1
10397,0,1,0,0,0,1
10398,0,0,1,0,0,1
10399,0,1,0,0,0,1
10400,0,0,0,1,0,1
10401,0,0,0,1,0,1
10402,0,1,0,0,0,1
10403,1,0,0,0,0,1
10404,0,1,0,0,0,1
10405,0,1,0,0,0,1
10406,1,0,0,0,0,1
10407,0,1,0,0,0,1
10408,0,1,0,0,0,1
10409,0,1,0,0,0,1
10410,1,0,0,0,0,1
10411,1,0,0,0,0,1
10412,1,0,0,0,0,1
10413,0,1,0,0,0,1
10414,0,1,0,0,0,1
10415,0,1,0,0,0,1
10416,0,0,0,1,0,1
10417,1,0,0,0,0,1
10418,1,0,0,0,0,1
10419,1,0,0,0,0,1
10420,1,0,0,0,0,1
10421,1,0,0,0,0,1
10422,0,0,0,0,1,1
10423,0,0,0,0,1,1
10424,1,0,0,0,0,1
10425,1,0,0,0,0,1
10426,0,1,0,0,0,1
10427,0,0,0,0,1,1
10428,1,0,0,0,0,1
10429,0,1,0,0,0,1
10430,0,1,0,0,0,1
10431,0,1,0,0,0,1
10432,0,1,0,0,0,1
10433,0,1,0,0,0,1
10434,0,1,0,0,0,1
10435,0,0,0,0,1,1
10436,0,1,0,0,0,1
10437,1,0,0,0,0,1
10438,1,0,0,0,0,1
10439,0,1,0,0,0,1
10440,1,0,0,0,0,1
10441,0,1,0,0,0,1
10442,1,0,0,0,0,1
10443,0,1,0,0,0,1
10444,0,1,0,0,0,1
10445,0,1,0,0,0,1
10446,0,1,0,0,0,1
10447,0,1,0,0,0,1
10448,0,1,0,0,0,1
10449,1,0,0,0,0,1
10450,0,1,0,0,0,1
10451,1,0,0,0,0,1
10452,0,0,1,0,0,1
10453,0,1,0,0,0,1
10454,0,0,1,0,0,1
10455,0,1,0,0,0,1
10456,0,1,0,0,0,1
10457,0,1,0,0,0,1
10458,0,0,0,0,1,1
10459,0,0,0,0,1,1
10460,1,0,0,0,0,1
10461,1,0,0,0,0,1
10462,0,0,0,0,1,1
10463,0,0,0,0,1,1
10464,1,0,0,0,0,1
10465,1,0,0,0,0,1
10466,0,0,0,0,1,1
10467,0,1,0,0,0,1
10468,0,0,0,0,1,1
10469,0,0,1,0,0,1
10470,0,0,1,0,0,1
10471,0,0,0,0,1,1
10472,0,1,0,0,0,1
10473,1,0,0,0,0,1
10474,1,0,0,0,0,1
10475,1,0,0,0,0,1
10476,0,1,0,0,0,1
10477,1,0,0,0,0,1
10478,1,0,0,0,0,1
10479,0,0,0,0,1,1
10480,0,0,0,0,1,1
10481,0,1,0,0,0,1
10482,0,0,0,0,1,1
10483,1,0,0,0,0,1
10484,0,1,0,0,0,1
10485,1,0,0,0,0,1
10486,0,0,0,0,1,1
10487,0,0,0,0,1,1
10488,0,1,0,0,0,1
10489,0,1,0,0,0,1
10490,1,0,0,0,0,1
10491,0,1,0,0,0,1
10492,0,1,0,0,0,1
10493,0,0,0,0,1,1
10494,0,0,0,0,1,1
10495,0,0,0,0,1,1
10496,1,0,0,0,0,1
10497,0,1,0,0,0,1
10498,0,1,0,0,0,1
10499,0,1,0,0,0,1
10500,0,0,1,0,0,1
10501,0,0,1,0,0,1
10502,0,0,1,0,0,1
10503,0,0,0,0,1,1
10504,0,1,0,0,0,1
10505,0,1,0,0,0,1
10506,1,0,0,0,0,1
10507,0,1,0,0,0,1
10508,1,0,0,0,0,1
10509,0,1,0,0,0,1
10510,0,1,0,0,0,1
10511,0,0,0,0,1,1
10512,0,0,0,0,1,1
10513,0,0,0,0,1,1
10514,0,0,0,0,1,1
10515,0,0,0,0,1,1
10516,0,0,0,0,1,1
10517,0,0,0,0,1,1
10518,0,1,0,0,0,1
10519,0,0,0,0,1,1
10520,1,0,0,0,0,1
10521,0,1,0,0,0,1
10522,1,0,0,0,0,1
10523,0,0,0,0,1,1
10524,1,0,0,0,0,1
10525,0,0,0,0,1,1
10526,1,0,0,0,0,1
10527,0,1,0,0,0,1
10528,0,1,0,0,0,1
10529,0,1,0,0,0,1
10530,0,1,0,0,0,1
10531,0,1,0,0,0,1
10532,0,0,0,0,1,1
10533,1,0,0,0,0,1
10534,1,0,0,0,0,1
10535,1,0,0,0,0,1
10536,1,0,0,0,0,1
10537,1,0,0,0,0,1
10538,0,1,0,0,0,1
10539,1,0,0,0,0,1
10540,1,0,0,0,0,1
10541,0,1,0,0,0,1
10542,0,0,0,0,1,1
10543,0,0,0,0,1,1
10544,0,1,0,0,0,1
10545,1,0,0,0,0,1
10546,1,0,0,0,0,1
10547,0,0,0,0,1,1
10548,0,1,0,0,0,1
10549,1,0,0,0,0,1
10550,0,0,0,1,0,1
10551,0,0,0,0,1,1
10552,0,0,0,0,1,1
10553,1,0,0,0,0,1
10554,1,0,0,0,0,1
10555,1,0,0,0,0,1
10556,0,0,0,1,0,1
10557,1,0,0,0,0,1
10558,1,0,0,0,0,1
10559,0,0,0,1,0,1
10560,1,0,0,0,0,1
10561,1,0,0,0,0,1
10562,1,0,0,0,0,1
10563,1,0,0,0,0,1
10564,0,1,0,0,0,1
10565,1,0,0,0,0,1
10566,1,0,0,0,0,1
10567,0,1,0,0,0,1
10568,0,1,0,0,0,1
10569,0,1,0,0,0,1
10570,0,0,1,0,0,1
10571,0,0,0,0,1,1
10572,0,0,1,0,0,1
10573,0,0,0,0,1,1
10574,0,0,0,0,1,1
10575,0,1,0,0,0,1
10576,0,1,0,0,0,1
10577,0,1,0,0,0,1
10578,0,0,0,0,1,1
10579,1,0,0,0,0,1
10580,0,1,0,0,0,1
10581,0,1,0,0,0,1
10582,1,0,0,0,0,1
10583,0,0,1,0,0,1
10584,0,1,0,0,0,1
10585,0,0,1,0,0,1
10586,0,1,0,0,0,1
10587,0,0,0,0,1,1
10588,0,0,0,0,1,1
10589,1,0,0,0,0,1
10590,1,0,0,0,0,1
10591,1,0,0,0,0,1
10592,0,0,0,0,1,1
10593,0,0,0,0,1,1
10594,1,0,0,0,0,1
10595,0,0,0,0,1,1
10596,0,0,0,0,1,1
10597,1,0,0,0,0,1
10598,0,0,1,0,0,1
10599,0,1,0,0,0,1
10600,0,1,0,0,0,1
10601,0,1,0,0,0,1
10602,0,1,0,0,0,1
10603,1,0,0,0,0,1
10604,0,0,1,0,0,1
10605,1,0,0,0,0,1
10606,0,0,0,0,1,1
10607,0,1,0,0,0,1
10608,0,0,0,0,1,1
10609,1,0,0,0,0,1
10610,0,1,0,0,0,1
10611,1,0,0,0,0,1
10612,0,0,0,0,1,1
10613,0,1,0,0,0,1
10614,0,0,0,0,1,1
10615,0,1,0,0,0,1
10616,0,1,0,0,0,1
10617,0,1,0,0,0,1
10618,0,1,0,0,0,1
10619,0,0,0,1,0,1
10620,0,1,0,0,0,1
10621,0,1,0,0,0,1
10622,0,1,0,0,0,1
10623,0,1,0,0,0,1
10624,0,1,0,0,0,1
10625,0,0,0,1,0,1
10626,0,0,0,1,0,1
10627,0,0,0,1,0,1
10628,0,1,0,0,0,1
10629,0,1,0,0,0,1
10630,0,1,0,0,0,1
10631,0,1,0,0,0,1
10632,0,1,0,0,0,1
10633,0,1,0,0,0,1
10634,0,0,0,0,1,1
10635,0,1,0,0,0,1
10636,0,1,0,0,0,1
10637,0,1,0,0,0,1
10638,0,0,0,0,1,1
10639,0,1,0,0,0,1
10640,0,0,0,0,1,1
10641,0,1,0,0,0,1
10642,0,0,0,1,0,1
10643,0,0,0,1,0,1
10644,0,1,0,0,0,1
10645,0,0,0,0,1,1
10646,0,0,0,0,1,1
10647,0,1,0,0,0,1
10648,0,0,0,0,1,1
10649,0,1,0,0,0,1
10650,0,0,0,0,1,1
10651,0,0,0,0,1,1
10652,0,0,0,0,1,1
10653,0,0,0,0,1,1
10654,0,0,0,0,1,1
10655,0,0,0,0,1,1
10656,0,1,0,0,0,1
10657,0,0,0,0,1,1
10658,0,0,0,0,1,1
10659,0,1,0,0,0,1
10660,0,0,0,0,1,1
10661,0,1,0,0,0,1
10662,0,1,0,0,0,1
10663,0,1,0,0,0,1
10664,0,0,0,0,1,1
10665,0,1,0,0,0,1
10666,0,0,0,0,1,1
10667,0,1,0,0,0,1
10668,0,1,0,0,0,1
10669,0,0,0,0,1,1
10670,0,1,0,0,0,1
10671,0,0,0,0,1,1
10672,1,0,0,0,0,1
10673,0,1,0,0,0,1
10674,0,1,0,0,0,1
10675,0,1,0,0,0,1
10676,0,0,0,0,1,1
10677,0,0,0,0,1,1
10678,0,1,0,0,0,1
10679,0,1,0,0,0,1
10680,0,0,0,0,1,1
10681,0,0,0,0,1,1
10682,0,0,0,0,1,1
10683,0,0,0,0,1,1
10684,0,0,0,0,1,1
10685,0,1,0,0,0,1
10686,0,0,0,0,1,1
10687,0,0,0,0,1,1
10688,0,1,0,0,0,1
10689,0,0,0,0,1,1
10690,1,0,0,0,0,1
10691,0,1,0,0,0,1
10692,1,0,0,0,0,1
10693,0,1,0,0,0,1
10694,0,0,0,0,1,1
10695,1,0,0,0,0,1
10696,0,1,0,0,0,1
10697,0,1,0,0,0,1
10698,0,1,0,0,0,1
10699,1,0,0,0,0,1
10700,1,0,0,0,0,1
10701,1,0,0,0,0,1
10702,0,1,0,0,0,1
10703,0,1,0,0,0,1
10704,0,1,0,0,0,1
10705,0,0,0,0,1,1
10706,0,1,0,0,0,1
10707,0,1,0,0,0,1
10708,0,1,0,0,0,1
10709,0,1,0,0,0,1
10710,0,0,0,0,1,1
10711,0,1,0,0,0,1
10712,0,1,0,0,0,1
10713,0,1,0,0,0,1
10714,0,1,0,0,0,1
10715,0,1,0,0,0,1
10716,0,0,0,0,1,1
10717,0,1,0,0,0,1
10718,0,0,0,0,1,1
10719,0,0,0,1,0,1
10720,0,0,0,0,1,1
10721,0,0,0,0,1,1
10722,0,1,0,0,0,1
10723,1,0,0,0,0,1
10724,0,1,0,0,0,1
10725,0,0,0,0,1,1
10726,0,1,0,0,0,1
10727,0,1,0,0,0,1
10728,0,1,0,0,0,1
10729,1,0,0,0,0,1
10730,0,0,0,0,1,1
10731,0,0,0,0,1,1
10732,0,1,0,0,0,1
10733,0,1,0,0,0,1
10734,0,1,0,0,0,1
10735,0,1,0,0,0,1
10736,0,0,0,1,0,1
10737,0,0,0,1,0,1
10738,0,0,0,1,0,1
10739,1,0,0,0,0,1
10740,0,0,1,0,0,1
10741,1,0,0,0,0,1
10742,1,0,0,0,0,1
10743,0,0,1,0,0,1
10744,0,0,1,0,0,1
10745,0,0,1,0,0,1
10746,0,0,0,0,1,1
10747,1,0,0,0,0,1
10748,0,0,0,0,1,1
10749,0,1,0,0,0,1
10750,0,1,0,0,0,1
10751,1,0,0,0,0,1
10752,0,0,0,0,1,1
10753,0,0,0,0,1,1
10754,0,0,1,0,0,1
10755,1,0,0,0,0,1
10756,1,0,0,0,0,1
10757,1,0,0,0,0,1
10758,1,0,0,0,0,1
10759,0,1,0,0,0,1
10760,1,0,0,0,0,1
10761,0,1,0,0,0,1
10762,0,0,0,0,1,1
10763,0,0,0,0,1,1
10764,1,0,0,0,0,1
10765,0,0,1,0,0,1
10766,1,0,0,0,0,1
10767,0,0,0,0,1,1
10768,0,0,0,0,1,1
10769,0,0,0,0,1,1
10770,0,0,0,1,0,1
10771,0,0,0,0,1,1
10772,0,1,0,0,0,1
10773,0,1,0,0,0,1
10774,1,0,0,0,0,1
10775,0,1,0,0,0,1
10776,0,1,0,0,0,1
10777,0,1,0,0,0,1
10778,1,0,0,0,0,1
10779,0,1,0,0,0,1
10780,1,0,0,0,0,1
10781,0,1,0,0,0,1
10782,0,1,0,0,0,1
10783,0,0,0,1,0,1
10784,0,0,0,1,0,1
10785,0,0,0,1,0,1
10786,0,0,0,1,0,1
10787,0,0,0,1,0,1
10788,0,0,0,1,0,1
10789,0,0,0,1,0,1
10790,1,0,0,0,0,1
10791,0,0,1,0,0,1
10792,1,0,0,0,0,1
10793,1,0,0,0,0,1
10794,0,0,1,0,0,1
10795,0,0,1,0,0,1
10796,0,0,0,0,1,1
10797,0,1,0,0,0,1
10798,0,1,0,0,0,1
10799,0,1,0,0,0,1
10800,0,1,0,0,0,1
10801,0,0,1,0,0,1
10802,0,1,0,0,0,1
10803,0,1,0,0,0,1
10804,0,0,0,0,1,1
10805,0,1,0,0,0,1
10806,0,1,0,0,0,1
10807,0,1,0,0,0,1
10808,0,1,0,0,0,1
10809,0,1,0,0,0,1
10810,0,1,0,0,0,1
10811,0,1,0,0,0,1
10812,0,0,1,0,0,1
10813,0,1,0,0,0,1
10814,0,1,0,0,0,1
10815,0,0,1,0,0,1
10816,0,0,1,0,0,1
10817,0,0,0,0,1,1
10818,0,0,0,0,1,1
10819,0,1,0,0,0,1
10820,0,0,0,0,1,1
10821,0,0,0,1,0,1
10822,1,0,0,0,0,1
10823,0,0,0,0,1,1
10824,1,0,0,0,0,1
10825,0,1,0,0,0,1
10826,0,1,0,0,0,1
10827,1,0,0,0,0,1
10828,0,1,0,0,0,1
10829,1,0,0,0,0,1
10830,1,0,0,0,0,1
10831,0,1,0,0,0,1
10832,0,1,0,0,0,1
10833,0,0,0,1,0,1
10834,0,0,1,0,0,1
10835,0,0,0,1,0,1
10836,0,0,0,1,0,1
10837,0,1,0,0,0,1
10838,0,0,0,0,1,1
10839,0,0,0,0,1,1
10840,0,0,0,0,1,1
10841,0,1,0,0,0,1
10842,0,0,0,1,0,1
10843,0,1,0,0,0,1
10844,1,0,0,0,0,1
10845,0,0,1,0,0,1
10846,1,0,0,0,0,1
10847,1,0,0,0,0,1
10848,1,0,0,0,0,1
10849,0,1,0,0,0,1
10850,0,0,1,0,0,1
10851,0,0,0,1,0,1
10852,0,1,0,0,0,1
10853,1,0,0,0,0,1
10854,0,1,0,0,0,1
10855,0,0,0,0,1,1
10856,0,1,0,0,0,1
10857,0,0,1,0,0,1
10858,0,0,0,0,1,1
10859,0,0,1,0,0,1
10860,0,0,0,0,1,1
10861,0,1,0,0,0,1
10862,0,0,0,0,1,1
10863,0,0,0,0,1,1
10864,0,0,0,0,1,1
10865,0,0,0,0,1,1
10866,1,0,0,0,0,1
10867,0,1,0,0,0,1
10868,0,1,0,0,0,1
10869,0,1,0,0,0,1
10870,0,1,0,0,0,1
10871,1,0,0,0,0,1
10872,0,1,0,0,0,1
10873,0,1,0,0,0,1
10874,0,0,0,0,1,1
10875,0,1,0,0,0,1
10876,0,1,0,0,0,1
10877,0,0,1,0,0,1
10878,1,0,0,0,0,1
10879,0,0,0,0,1,1
10880,1,0,0,0,0,1
10881,1,0,0,0,0,1
10882,1,0,0,0,0,1
10883,1,0,0,0,0,1
10884,1,0,0,0,0,1
10885,0,0,0,0,1,1
10886,0,1,0,0,0,1
10887,0,1,0,0,0,1
10888,1,0,0,0,0,1
10889,1,0,0,0,0,1
10890,0,1,0,0,0,1
10891,0,1,0,0,0,1
10892,0,0,1,0,0,1
10893,1,0,0,0,0,1
10894,0,1,0,0,0,1
10895,0,0,0,1,0,1
10896,0,1,0,0,0,1
10897,0,1,0,0,0,1
10898,0,0,1,0,0,1
10899,0,1,0,0,0,1
10900,0,1,0,0,0,1
10901,0,1,0,0,0,1
10902,0,0,0,0,1,1
10903,0,0,0,0,1,1
10904,0,0,0,0,1,1
10905,0,0,0,0,1,1
10906,0,0,0,0,1,1
10907,0,0,1,0,0,1
10908,0,1,0,0,0,1
10909,0,1,0,0,0,1
10910,0,1,0,0,0,1
10911,0,0,1,0,0,1
10912,0,0,1,0,0,1
10913,0,1,0,0,0,1
10914,0,0,1,0,0,1
10915,0,1,0,0,0,1
10916,0,1,0,0,0,1
10917,0,0,0,1,0,1
10918,0,1,0,0,0,1
10919,0,0,0,0,1,1
10920,0,0,1,0,0,1
10921,0,1,0,0,0,1
10922,0,1,0,0,0,1
10923,0,1,0,0,0,1
10924,0,1,0,0,0,1
10925,0,1,0,0,0,1
10926,0,1,0,0,0,1
10927,1,0,0,0,0,1
10928,1,0,0,0,0,1
10929,0,1,0,0,0,1
10930,0,1,0,0,0,1
10931,0,0,0,1,0,1
10932,0,0,0,1,0,1
10933,0,0,0,1,0,1
10934,0,0,0,0,1,1
10935,0,1,0,0,0,1
10936,0,1,0,0,0,1
10937,0,0,1,0,0,1
10938,0,0,1,0,0,1
10939,0,1,0,0,0,1
10940,0,1,0,0,0,1
10941,0,0,0,1,0,1
10942,0,1,0,0,0,1
10943,0,1,0,0,0,1
10944,1,0,0,0,0,1
10945,1,0,0,0,0,1
10946,0,0,0,0,1,1
10947,0,0,0,0,1,1
10948,0,0,0,0,1,1
10949,1,0,0,0,0,1
10950,0,0,0,0,1,1
10951,0,0,0,0,1,1
10952,0,1,0,0,0,1
10953,0,0,0,1,0,1
10954,1,0,0,0,0,1
10955,1,0,0,0,0,1
10956,0,1,0,0,0,1
10957,0,1,0,0,0,1
10958,0,0,1,0,0,1
10959,0,1,0,0,0,1
10960,0,0,0,1,0,1
10961,0,0,0,1,0,1
10962,0,1,0,0,0,1
10963,0,1,0,0,0,1
10964,0,1,0,0,0,1
10965,0,1,0,0,0,1
10966,0,1,0,0,0,1
10967,1,0,0,0,0,1
10968,0,0,1,0,0,1
10969,0,0,0,0,1,1
10970,0,1,0,0,0,1
10971,0,1,0,0,0,1
10972,0,1,0,0,0,1
10973,0,1,0,0,0,1
10974,0,0,0,1,0,1
10975,0,1,0,0,0,1
10976,0,1,0,0,0,1
10977,0,1,0,0,0,1
10978,0,0,0,1,0,1
10979,0,1,0,0,0,1
10980,0,1,0,0,0,1
10981,0,1,0,0,0,1
10982,0,1,0,0,0,1
10983,0,1,0,0,0,1
10984,0,1,0,0,0,1
10985,0,1,0,0,0,1
10986,0,0,0,1,0,1
10987,0,0,0,1,0,1
10988,0,1,0,0,0,1
10989,0,1,0,0,0,1
10990,0,1,0,0,0,1
10991,0,1,0,0,0,1
10992,0,1,0,0,0,1
10993,0,0,0,0,1,1
10994,0,0,0,0,1,1
10995,0,0,0,0,1,1
10996,0,1,0,0,0,1
10997,0,1,0,0,0,1
10998,0,1,0,0,0,1
10999,0,1,0,0,0,1
11000,0,1,0,0,0,1
11001,0,0,0,1,0,1
11002,0,0,0,0,1,1
11003,0,0,0,0,1,1
11004,0,0,0,0,1,1
11005,0,0,0,0,1,1
11006,0,0,0,0,1,1
11007,0,0,0,0,1,1
11008,0,0,0,0,1,1
11009,0,0,1,0,0,1
11010,0,1,0,0,0,1
11011,1,0,0,0,0,1
11012,0,1,0,0,0,1
11013,1,0,0,0,0,1
11014,1,0,0,0,0,1
11015,0,1,0,0,0,1
11016,0,0,0,0,1,1
11017,1,0,0,0,0,1
11018,1,0,0,0,0,1
11019,1,0,0,0,0,1
11020,1,0,0,0,0,1
11021,0,0,0,0,1,1
11022,1,0,0,0,0,1
11023,0,1,0,0,0,1
11024,0,0,1,0,0,1
11025,0,1,0,0,0,1
11026,0,1,0,0,0,1
11027,0,0,0,1,0,1
11028,0,0,0,1,0,1
11029,0,1,0,0,0,1
11030,0,1,0,0,0,1
11031,0,1,0,0,0,1
11032,0,1,0,0,0,1
11033,0,1,0,0,0,1
11034,0,1,0,0,0,1
11035,0,1,0,0,0,1
11036,0,1,0,0,0,1
11037,0,1,0,0,0,1
11038,0,1,0,0,0,1
11039,0,1,0,0,0,1
11040,1,0,0,0,0,1
11041,0,1,0,0,0,1
11042,0,1,0,0,0,1
11043,0,0,0,1,0,1
11044,0,1,0,0,0,1
11045,0,0,0,1,0,1
11046,0,0,0,1,0,1
11047,0,0,0,1,0,1
11048,0,0,0,1,0,1
11049,0,0,1,0,0,1
11050,0,0,1,0,0,1
11051,0,1,0,0,0,1
11052,0,1,0,0,0,1
11053,0,0,1,0,0,1
11054,0,0,0,0,1,1
11055,0,1,0,0,0,1
11056,0,0,1,0,0,1
11057,0,1,0,0,0,1
11058,1,0,0,0,0,1
11059,0,1,0,0,0,1
11060,0,0,0,0,1,1
11061,0,1,0,0,0,1
11062,0,1,0,0,0,1
11063,0,1,0,0,0,1
11064,0,1,0,0,0,1
11065,0,0,0,1,0,1
11066,0,0,0,1,0,1
11067,0,0,0,1,0,1
11068,0,0,0,1,0,1
11069,0,0,0,1,0,1
11070,0,0,0,1,0,1
11071,0,0,0,1,0,1
11072,0,0,0,1,0,1
11073,0,0,0,1,0,1
11074,0,0,0,1,0,1
11075,0,0,1,0,0,1
11076,0,0,0,1,0,1
11077,0,0,1,0,0,1
11078,0,0,0,1,0,1
11079,0,0,1,0,0,1
11080,0,1,0,0,0,1
11081,0,1,0,0,0,1
11082,0,1,0,0,0,1
11083,0,0,0,1,0,1
11084,0,1,0,0,0,1
11085,0,1,0,0,0,1
11086,0,1,0,0,0,1
11087,0,1,0,0,0,1
11088,0,1,0,0,0,1
11089,0,1,0,0,0,1
11090,1,0,0,0,0,1
11091,0,1,0,0,0,1
11092,1,0,0,0,0,1
11093,1,0,0,0,0,1
11094,0,0,0,0,1,1
11095,1,0,0,0,0,1
11096,0,1,0,0,0,1
11097,1,0,0,0,0,1
11098,0,1,0,0,0,1
11099,0,1,0,0,0,1
11100,1,0,0,0,0,1
11101,0,1,0,0,0,1
11102,1,0,0,0,0,1
11103,1,0,0,0,0,1
11104,1,0,0,0,0,1
11105,0,1,0,0,0,1
11106,0,1,0,0,0,1
11107,0,1,0,0,0,1
11108,0,1,0,0,0,1
11109,0,1,0,0,0,1
11110,0,1,0,0,0,1
11111,0,1,0,0,0,1
11112,0,0,1,0,0,1
11113,0,1,0,0,0,1
11114,0,0,0,0,1,1
11115,0,1,0,0,0,1
11116,0,1,0,0,0,1
11117,0,1,0,0,0,1
11118,0,1,0,0,0,1
11119,0,1,0,0,0,1
11120,1,0,0,0,0,1
11121,0,0,1,0,0,1
11122,0,0,0,1,0,1
11123,0,0,0,1,0,1
11124,1,0,0,0,0,1
11125,0,0,0,1,0,1
11126,0,0,1,0,0,1
11127,0,0,1,0,0,1
11128,0,0,0,1,0,1
11129,0,0,0,1,0,1
11130,0,0,1,0,0,1
11131,0,0,1,0,0,1
11132,0,0,0,1,0,1
11133,0,1,0,0,0,1
11134,0,0,0,0,1,1
11135,0,1,0,0,0,1
11136,0,1,0,0,0,1
11137,0,1,0,0,0,1
11138,0,0,0,1,0,1
11139,0,1,0,0,0,1
11140,0,0,0,0,1,1
11141,0,1,0,0,0,1
11142,0,1,0,0,0,1
11143,0,1,0,0,0,1
11144,1,0,0,0,0,1
11145,0,1,0,0,0,1
11146,0,1,0,0,0,1
11147,0,1,0,0,0,1
11148,0,0,0,0,1,1
11149,1,0,0,0,0,1
11150,1,0,0,0,0,1
11151,0,1,0,0,0,1
11152,0,1,0,0,0,1
11153,1,0,0,0,0,1
11154,0,0,0,0,1,1
11155,0,0,0,0,1,1
11156,0,1,0,0,0,1
11157,0,1,0,0,0,1
11158,0,1,0,0,0,1
11159,0,1,0,0,0,1
11160,1,0,0,0,0,1
11161,1,0,0,0,0,1
11162,1,0,0,0,0,1
11163,1,0,0,0,0,1
11164,1,0,0,0,0,1
11165,1,0,0,0,0,1
11166,0,0,1,0,0,1
11167,1,0,0,0,0,1
11168,0,0,1,0,0,1
11169,1,0,0,0,0,1
11170,0,0,1,0,0,1
11171,0,1,0,0,0,1
11172,0,1,0,0,0,1
11173,0,0,0,0,1,1
11174,0,1,0,0,0,1
11175,0,0,0,0,1,1
11176,0,0,0,0,1,1
11177,0,0,0,0,1,1
11178,1,0,0,0,0,1
11179,1,0,0,0,0,1
11180,0,1,0,0,0,1
11181,0,0,0,0,1,1
11182,0,1,0,0,0,1
11183,0,1,0,0,0,1
11184,1,0,0,0,0,1
11185,1,0,0,0,0,1
11186,0,0,0,0,1,1
11187,0,0,1,0,0,1
11188,0,1,0,0,0,1
11189,0,1,0,0,0,1
11190,0,0,0,0,1,1
11191,0,1,0,0,0,1
11192,1,0,0,0,0,1
11193,0,1,0,0,0,1
11194,0,1,0,0,0,1
11195,0,1,0,0,0,1
11196,0,1,0,0,0,1
11197,0,1,0,0,0,1
11198,1,0,0,0,0,1
11199,1,0,0,0,0,1
11200,0,1,0,0,0,1
11201,0,1,0,0,0,1
11202,1,0,0,0,0,1
11203,0,1,0,0,0,1
11204,1,0,0,0,0,1
11205,1,0,0,0,0,1
11206,1,0,0,0,0,1
11207,0,1,0,0,0,1
11208,0,1,0,0,0,1
11209,0,1,0,0,0,1
11210,0,1,0,0,0,1
11211,1,0,0,0,0,1
11212,0,1,0,0,0,1
11213,0,1,0,0,0,1
11214,0,1,0,0,0,1
11215,0,1,0,0,0,1
11216,1,0,0,0,0,1
11217,1,0,0,0,0,1
11218,1,0,0,0,0,1
11219,1,0,0,0,0,1
11220,1,0,0,0,0,1
11221,1,0,0,0,0,1
11222,1,0,0,0,0,1
11223,1,0,0,0,0,1
11224,0,1,0,0,0,1
11225,0,0,0,0,1,1
11226,0,1,0,0,0,1
11227,0,1,0,0,0,1
11228,1,0,0,0,0,1
11229,1,0,0,0,0,1
11230,1,0,0,0,0,1
11231,1,0,0,0,0,1
11232,0,1,0,0,0,1
11233,1,0,0,0,0,1
11234,0,1,0,0,0,1
11235,1,0,0,0,0,1
11236,0,1,0,0,0,1
11237,0,1,0,0,0,1
11238,0,0,0,0,1,1
11239,0,1,0,0,0,1
11240,0,1,0,0,0,1
11241,0,1,0,0,0,1
11242,0,1,0,0,0,1
11243,0,1,0,0,0,1
11244,0,1,0,0,0,1
11245,0,1,0,0,0,1
11246,0,1,0,0,0,1
11247,0,1,0,0,0,1
11248,0,1,0,0,0,1
11249,0,1,0,0,0,1
11250,0,1,0,0,0,1
11251,0,1,0,0,0,1
11252,0,1,0,0,0,1
11253,0,1,0,0,0,1
11254,1,0,0,0,0,1
11255,1,0,0,0,0,1
11256,0,1,0,0,0,1
11257,0,0,1,0,0,1
11258,0,0,1,0,0,1
11259,1,0,0,0,0,1
11260,0,1,0,0,0,1
11261,0,1,0,0,0,1
11262,0,1,0,0,0,1
11263,1,0,0,0,0,1
11264,1,0,0,0,0,1
11265,0,1,0,0,0,1
11266,1,0,0,0,0,1
11267,1,0,0,0,0,1
11268,0,0,0,0,1,1
11269,1,0,0,0,0,1
11270,1,0,0,0,0,1
11271,1,0,0,0,0,1
11272,1,0,0,0,0,1
11273,0,0,1,0,0,1
11274,1,0,0,0,0,1
11275,1,0,0,0,0,1
11276,0,0,0,0,1,1
11277,0,1,0,0,0,1
11278,0,1,0,0,0,1
11279,1,0,0,0,0,1
11280,1,0,0,0,0,1
11281,0,1,0,0,0,1
11282,0,1,0,0,0,1
11283,0,1,0,0,0,1
11284,0,1,0,0,0,1
11285,0,1,0,0,0,1
11286,0,1,0,0,0,1
11287,0,1,0,0,0,1
11288,0,1,0,0,0,1
11289,0,1,0,0,0,1
11290,0,1,0,0,0,1
11291,0,1,0,0,0,1
11292,0,1,0,0,0,1
11293,1,0,0,0,0,1
11294,1,0,0,0,0,1
11295,1,0,0,0,0,1
11296,1,0,0,0,0,1
11297,1,0,0,0,0,1
11298,1,0,0,0,0,1
11299,1,0,0,0,0,1
11300,0,1,0,0,0,1
11301,0,0,1,0,0,1
11302,1,0,0,0,0,1
11303,1,0,0,0,0,1
11304,0,0,0,0,1,1
11305,1,0,0,0,0,1
11306,1,0,0,0,0,1
11307,1,0,0,0,0,1
11308,1,0,0,0,0,1
11309,1,0,0,0,0,1
11310,1,0,0,0,0,1
11311,1,0,0,0,0,1
11312,0,0,1,0,0,1
11313,0,0,1,0,0,1
11314,0,0,1,0,0,1
11315,0,0,1,0,0,1
11316,1,0,0,0,0,1
11317,1,0,0,0,0,1
11318,1,0,0,0,0,1
11319,1,0,0,0,0,1
11320,1,0,0,0,0,1
11321,0,1,0,0,0,1
11322,0,1,0,0,0,1
11323,0,1,0,0,0,1
11324,1,0,0,0,0,1
11325,1,0,0,0,0,1
11326,1,0,0,0,0,1
11327,0,1,0,0,0,1
11328,0,1,0,0,0,1
11329,0,1,0,0,0,1
11330,0,0,0,1,0,1
11331,0,1,0,0,0,1
11332,0,1,0,0,0,1
11333,0,0,0,1,0,1
11334,0,0,0,1,0,1
11335,0,0,0,1,0,1
11336,0,1,0,0,0,1
11337,0,1,0,0,0,1
11338,0,1,0,0,0,1
11339,0,1,0,0,0,1
11340,0,1,0,0,0,1
11341,0,1,0,0,0,1
11342,0,1,0,0,0,1
11343,0,1,0,0,0,1
11344,0,1,0,0,0,1
11345,0,1,0,0,0,1
11346,0,1,0,0,0,1
11347,0,1,0,0,0,1
11348,0,1,0,0,0,1
11349,0,1,0,0,0,1
11350,0,1,0,0,0,1
11351,0,1,0,0,0,1
11352,0,1,0,0,0,1
11353,0,1,0,0,0,1
11354,0,1,0,0,0,1
11355,0,1,0,0,0,1
11356,0,1,0,0,0,1
11357,0,1,0,0,0,1
11358,0,1,0,0,0,1
11359,0,1,0,0,0,1
11360,0,1,0,0,0,1
11361,0,1,0,0,0,1
11362,0,1,0,0,0,1
11363,0,1,0,0,0,1
11364,0,1,0,0,0,1
11365,0,1,0,0,0,1
11366,1,0,0,0,0,1
11367,1,0,0,0,0,1
11368,1,0,0,0,0,1
11369,1,0,0,0,0,1
11370,0,1,0,0,0,1
11371,0,0,0,1,0,1
11372,0,0,0,1,0,1
11373,1,0,0,0,0,1
11374,0,0,0,0,1,1
11375,0,1,0,0,0,1
11376,0,0,0,0,1,1
11377,0,0,0,0,1,1
11378,0,1,0,0,0,1
11379,1,0,0,0,0,1
11380,1,0,0,0,0,1
11381,0,1,0,0,0,1
11382,0,1,0,0,0,1
11383,0,1,0,0,0,1
11384,0,1,0,0,0,1
11385,1,0,0,0,0,1
11386,0,1,0,0,0,1
11387,0,1,0,0,0,1
11388,0,1,0,0,0,1
11389,1,0,0,0,0,1
11390,0,1,0,0,0,1
11391,0,1,0,0,0,1
11392,0,1,0,0,0,1
11393,0,0,0,0,1,1
11394,0,1,0,0,0,1
11395,0,1,0,0,0,1
11396,0,1,0,0,0,1
11397,0,1,0,0,0,1
11398,0,0,0,0,1,1
11399,0,1,0,0,0,1
11400,0,1,0,0,0,1
11401,1,0,0,0,0,1
11402,0,1,0,0,0,1
11403,1,0,0,0,0,1
11404,1,0,0,0,0,1
11405,1,0,0,0,0,1
11406,0,1,0,0,0,1
11407,1,0,0,0,0,1
11408,0,1,0,0,0,1
11409,0,1,0,0,0,1
11410,1,0,0,0,0,1
11411,0,1,0,0,0,1
11412,0,0,0,1,0,1
11413,0,0,0,1,0,1
11414,0,0,0,1,0,1
11415,0,0,0,1,0,1
11416,0,1,0,0,0,1
11417,0,1,0,0,0,1
11418,0,1,0,0,0,1
11419,0,1,0,0,0,1
11420,0,0,1,0,0,1
11421,0,0,0,0,1,1
11422,0,0,0,0,1,1
11423,0,0,0,1,0,1
11424,0,0,1,0,0,1
11425,0,0,1,0,0,1
11426,0,0,0,1,0,1
11427,0,0,0,1,0,1
11428,0,1,0,0,0,1
11429,0,0,0,1,0,1
11430,0,1,0,0,0,1
11431,1,0,0,0,0,1
11432,0,0,0,0,1,1
11433,0,0,0,0,1,1
11434,0,1,0,0,0,1
11435,0,0,0,0,1,1
11436,0,0,0,0,1,1
11437,1,0,0,0,0,1
11438,0,1,0,0,0,1
11439,0,1,0,0,0,1
11440,0,1,0,0,0,1
11441,0,1,0,0,0,1
11442,1,0,0,0,0,1
11443,0,1,0,0,0,1
11444,1,0,0,0,0,1
11445,1,0,0,0,0,1
11446,0,1,0,0,0,1
11447,0,1,0,0,0,1
11448,1,0,0,0,0,1
11449,0,1,0,0,0,1
11450,0,1,0,0,0,1
11451,0,1,0,0,0,1
11452,1,0,0,0,0,1
11453,1,0,0,0,0,1
11454,0,1,0,0,0,1
11455,0,1,0,0,0,1
11456,0,1,0,0,0,1
11457,0,1,0,0,0,1
11458,0,1,0,0,0,1
11459,0,1,0,0,0,1
11460,1,0,0,0,0,1
11461,0,1,0,0,0,1
11462,0,1,0,0,0,1
11463,0,1,0,0,0,1
11464,1,0,0,0,0,1
11465,0,1,0,0,0,1
11466,0,0,1,0,0,1
11467,0,1,0,0,0,1
11468,0,1,0,0,0,1
11469,0,1,0,0,0,1
11470,1,0,0,0,0,1
11471,1,0,0,0,0,1
11472,0,1,0,0,0,1
11473,0,1,0,0,0,1
11474,0,1,0,0,0,1
11475,1,0,0,0,0,1
11476,0,1,0,0,0,1
11477,0,1,0,0,0,1
11478,1,0,0,0,0,1
11479,1,0,0,0,0,1
11480,0,0,0,0,1,1
11481,0,0,0,0,1,1
11482,0,0,0,0,1,1
11483,0,1,0,0,0,1
11484,0,1,0,0,0,1
11485,0,1,0,0,0,1
11486,1,0,0,0,0,1
11487,0,1,0,0,0,1
11488,0,1,0,0,0,1
11489,1,0,0,0,0,1
11490,0,1,0,0,0,1
11491,0,1,0,0,0,1
11492,0,1,0,0,0,1
11493,0,1,0,0,0,1
11494,1,0,0,0,0,1
11495,1,0,0,0,0,1
11496,1,0,0,0,0,1
11497,0,1,0,0,0,1
11498,1,0,0,0,0,1
11499,1,0,0,0,0,1
11500,0,1,0,0,0,1
11501,0,1,0,0,0,1
11502,0,1,0,0,0,1
11503,1,0,0,0,0,1
11504,0,1,0,0,0,1
11505,1,0,0,0,0,1
11506,0,1,0,0,0,1
11507,1,0,0,0,0,1
11508,0,1,0,0,0,1
11509,1,0,0,0,0,1
11510,0,1,0,0,0,1
11511,0,0,0,1,0,1
11512,0,1,0,0,0,1
11513,0,1,0,0,0,1
11514,0,1,0,0,0,1
11515,1,0,0,0,0,1
11516,0,1,0,0,0,1
11517,0,1,0,0,0,1
11518,0,1,0,0,0,1
11519,0,1,0,0,0,1
11520,1,0,0,0,0,1
11521,1,0,0,0,0,1
11522,0,1,0,0,0,1
11523,1,0,0,0,0,1
11524,0,1,0,0,0,1
11525,1,0,0,0,0,1
11526,0,1,0,0,0,1
11527,0,1,0,0,0,1
11528,1,0,0,0,0,1
11529,0,1,0,0,0,1
11530,0,1,0,0,0,1
11531,0,1,0,0,0,1
11532,0,0,0,1,0,1
11533,0,0,0,1,0,1
11534,0,1,0,0,0,1
11535,1,0,0,0,0,1
11536,0,0,0,1,0,1
11537,0,1,0,0,0,1
11538,0,1,0,0,0,1
11539,0,1,0,0,0,1
11540,0,1,0,0,0,1
11541,1,0,0,0,0,1
11542,1,0,0,0,0,1
11543,0,1,0,0,0,1
11544,1,0,0,0,0,1
11545,0,0,0,1,0,1
11546,0,1,0,0,0,1
11547,0,0,1,0,0,1
11548,0,0,1,0,0,1
11549,0,0,1,0,0,1
11550,0,1,0,0,0,1
11551,0,1,0,0,0,1
11552,0,1,0,0,0,1
11553,0,1,0,0,0,1
11554,0,1,0,0,0,1
11555,1,0,0,0,0,1
11556,0,0,0,1,0,1
11557,1,0,0,0,0,1
11558,0,1,0,0,0,1
11559,0,1,0,0,0,1
11560,1,0,0,0,0,1
11561,0,1,0,0,0,1
11562,0,1,0,0,0,1
11563,0,0,1,0,0,1
11564,0,1,0,0,0,1
11565,0,1,0,0,0,1
11566,0,1,0,0,0,1
11567,1,0,0,0,0,1
11568,1,0,0,0,0,1
11569,0,0,1,0,0,1
11570,0,0,1,0,0,1
11571,0,1,0,0,0,1
11572,0,0,0,0,1,1
11573,1,0,0,0,0,1
11574,0,1,0,0,0,1
11575,0,0,0,1,0,1
11576,0,1,0,0,0,1
11577,0,1,0,0,0,1
11578,0,0,0,1,0,1
11579,0,1,0,0,0,1
11580,1,0,0,0,0,1
11581,1,0,0,0,0,1
11582,0,0,0,1,0,1
11583,0,0,0,0,1,1
11584,1,0,0,0,0,1
11585,1,0,0,0,0,1
11586,0,1,0,0,0,1
11587,0,1,0,0,0,1
11588,0,0,0,1,0,1
11589,0,0,1,0,0,1
11590,1,0,0,0,0,1
11591,1,0,0,0,0,1
11592,0,0,0,1,0,1
11593,0,1,0,0,0,1
11594,1,0,0,0,0,1
11595,0,0,0,0,1,1
11596,0,1,0,0,0,1
11597,0,1,0,0,0,1
11598,0,1,0,0,0,1
11599,0,1,0,0,0,1
11600,0,0,1,0,0,1
11601,0,0,0,0,1,1
11602,0,1,0,0,0,1
11603,1,0,0,0,0,1
11604,0,0,0,0,1,1
11605,0,0,1,0,0,1
11606,0,0,1,0,0,1
11607,0,1,0,0,0,1
11608,0,0,0,0,1,1
11609,0,1,0,0,0,1
11610,0,1,0,0,0,1
11611,0,1,0,0,0,1
11612,0,0,0,1,0,1
11613,0,0,0,1,0,1
11614,0,1,0,0,0,1
11615,0,0,0,1,0,1
11616,1,0,0,0,0,1
11617,0,1,0,0,0,1
11618,0,0,0,1,0,1
11619,0,0,0,1,0,1
11620,0,0,0,1,0,1
11621,0,1,0,0,0,1
11622,0,1,0,0,0,1
11623,0,1,0,0,0,1
11624,0,1,0,0,0,1
11625,1,0,0,0,0,1
11626,1,0,0,0,0,1
11627,1,0,0,0,0,1
11628,1,0,0,0,0,1
11629,0,1,0,0,0,1
11630,0,1,0,0,0,1
11631,0,1,0,0,0,1
11632,0,0,0,1,0,1
11633,0,0,0,1,0,1
11634,0,0,0,0,1,1
11635,0,1,0,0,0,1
11636,0,0,0,1,0,1
11637,0,0,0,0,1,1
11638,0,1,0,0,0,1
11639,0,1,0,0,0,1
11640,0,1,0,0,0,1
11641,1,0,0,0,0,1
11642,0,1,0,0,0,1
11643,0,1,0,0,0,1
11644,0,1,0,0,0,1
11645,0,1,0,0,0,1
11646,0,0,0,1,0,1
11647,1,0,0,0,0,1
11648,0,0,0,0,1,1
11649,0,1,0,0,0,1
11650,0,1,0,0,0,1
11651,0,0,0,1,0,1
11652,0,1,0,0,0,1
11653,0,1,0,0,0,1
11654,0,0,0,1,0,1
11655,0,0,0,1,0,1
11656,0,1,0,0,0,1
11657,0,0,0,1,0,1
11658,0,0,0,1,0,1
11659,0,0,1,0,0,1
11660,0,0,0,1,0,1
11661,0,1,0,0,0,1
11662,0,1,0,0,0,1
11663,0,1,0,0,0,1
11664,0,0,0,1,0,1
11665,0,0,0,1,0,1
11666,0,0,0,1,0,1
11667,0,1,0,0,0,1
11668,0,1,0,0,0,1
11669,0,0,0,1,0,1
11670,0,0,0,1,0,1
11671,0,1,0,0,0,1
11672,0,1,0,0,0,1
11673,0,1,0,0,0,1
11674,0,0,1,0,0,1
11675,0,0,0,1,0,1
11676,0,0,0,1,0,1
11677,0,1,0,0,0,1
11678,0,1,0,0,0,1
11679,0,0,0,0,1,1
11680,0,0,0,0,1,1
11681,0,1,0,0,0,1
11682,0,0,0,0,1,1
11683,0,1,0,0,0,1
11684,0,0,0,1,0,1
11685,0,1,0,0,0,1
11686,0,1,0,0,0,1
11687,0,1,0,0,0,1
11688,0,0,0,0,1,1
11689,0,1,0,0,0,1
11690,0,0,0,1,0,1
11691,0,0,0,1,0,1
11692,0,1,0,0,0,1
11693,0,1,0,0,0,1
11694,1,0,0,0,0,1
11695,1,0,0,0,0,1
11696,0,1,0,0,0,1
11697,0,1,0,0,0,1
11698,0,1,0,0,0,1
11699,1,0,0,0,0,1
11700,0,1,0,0,0,1
11701,0,1,0,0,0,1
11702,0,1,0,0,0,1
11703,0,1,0,0,0,1
11704,0,1,0,0,0,1
11705,0,1,0,0,0,1
11706,0,1,0,0,0,1
11707,0,0,0,1,0,1
11708,0,1,0,0,0,1
11709,0,1,0,0,0,1
11710,0,1,0,0,0,1
11711,0,1,0,0,0,1
11712,0,0,0,1,0,1
11713,0,0,0,1,0,1
11714,0,1,0,0,0,1
11715,0,1,0,0,0,1
11716,0,1,0,0,0,1
11717,0,1,0,0,0,1
11718,0,1,0,0,0,1
11719,0,1,0,0,0,1
11720,0,1,0,0,0,1
11721,1,0,0,0,0,1
11722,1,0,0,0,0,1
11723,0,1,0,0,0,1
11724,0,1,0,0,0,1
11725,0,1,0,0,0,1
11726,0,1,0,0,0,1
11727,0,0,0,1,0,1
11728,0,1,0,0,0,1
11729,0,0,0,1,0,1
11730,0,1,0,0,0,1
11731,0,1,0,0,0,1
11732,0,1,0,0,0,1
11733,0,0,0,0,1,1
11734,0,1,0,0,0,1
11735,0,1,0,0,0,1
11736,1,0,0,0,0,1
11737,0,1,0,0,0,1
11738,0,1,0,0,0,1
11739,0,1,0,0,0,1
11740,0,0,0,1,0,1
11741,0,0,1,0,0,1
11742,1,0,0,0,0,1
11743,1,0,0,0,0,1
11744,0,0,0,0,1,1
11745,1,0,0,0,0,1
11746,0,1,0,0,0,1
11747,0,1,0,0,0,1
11748,0,1,0,0,0,1
11749,1,0,0,0,0,1
11750,1,0,0,0,0,1
11751,1,0,0,0,0,1
11752,1,0,0,0,0,1
11753,0,0,1,0,0,1
11754,1,0,0,0,0,1
11755,1,0,0,0,0,1
11756,0,0,1,0,0,1
11757,0,0,1,0,0,1
11758,1,0,0,0,0,1
11759,0,1,0,0,0,1
11760,1,0,0,0,0,1
11761,0,0,1,0,0,1
11762,0,0,1,0,0,1
11763,0,0,0,0,1,1
11764,0,0,0,0,1,1
11765,1,0,0,0,0,1
11766,0,1,0,0,0,1
11767,0,1,0,0,0,1
11768,0,0,0,1,0,1
11769,1,0,0,0,0,1
11770,1,0,0,0,0,1
11771,0,0,0,1,0,1
11772,0,1,0,0,0,1
11773,0,1,0,0,0,1
11774,0,0,0,0,1,1
11775,0,1,0,0,0,1
11776,0,1,0,0,0,1
11777,0,1,0,0,0,1
11778,0,0,0,0,1,1
11779,1,0,0,0,0,1
11780,0,0,0,0,1,1
11781,0,1,0,0,0,1
11782,1,0,0,0,0,1
11783,0,0,0,1,0,1
11784,1,0,0,0,0,1
11785,0,0,0,1,0,1
11786,1,0,0,0,0,1
11787,1,0,0,0,0,1
11788,1,0,0,0,0,1
11789,0,0,0,1,0,1
11790,0,0,0,1,0,1
11791,1,0,0,0,0,1
11792,0,0,1,0,0,1
11793,1,0,0,0,0,1
11794,1,0,0,0,0,1
11795,0,1,0,0,0,1
11796,1,0,0,0,0,1
11797,1,0,0,0,0,1
11798,0,1,0,0,0,1
11799,0,1,0,0,0,1
11800,0,1,0,0,0,1
11801,0,1,0,0,0,1
11802,0,1,0,0,0,1
11803,0,1,0,0,0,1
11804,1,0,0,0,0,1
11805,0,0,0,1,0,1
11806,0,1,0,0,0,1
11807,0,1,0,0,0,1
11808,0,0,0,1,0,1
11809,0,1,0,0,0,1
11810,0,1,0,0,0,1
11811,0,1,0,0,0,1
11812,0,1,0,0,0,1
11813,1,0,0,0,0,1
11814,0,1,0,0,0,1
11815,0,1,0,0,0,1
11816,1,0,0,0,0,1
11817,1,0,0,0,0,1
11818,0,1,0,0,0,1
11819,1,0,0,0,0,1
11820,1,0,0,0,0,1
11821,1,0,0,0,0,1
11822,0,0,1,0,0,1
11823,0,0,1,0,0,1
11824,0,0,1,0,0,1
11825,1,0,0,0,0,1
11826,1,0,0,0,0,1
11827,0,0,1,0,0,1
11828,0,1,0,0,0,1
11829,0,1,0,0,0,1
11830,1,0,0,0,0,1
11831,0,1,0,0,0,1
11832,1,0,0,0,0,1
11833,1,0,0,0,0,1
11834,1,0,0,0,0,1
11835,0,1,0,0,0,1
11836,0,1,0,0,0,1
11837,0,1,0,0,0,1
11838,0,0,0,0,1,1
11839,0,0,0,0,1,1
11840,0,1,0,0,0,1
11841,1,0,0,0,0,1
11842,1,0,0,0,0,1
11843,0,1,0,0,0,1
11844,0,1,0,0,0,1
11845,1,0,0,0,0,1
11846,0,0,0,0,1,1
11847,0,0,0,0,1,1
11848,1,0,0,0,0,1
11849,0,1,0,0,0,1
11850,0,1,0,0,0,1
11851,0,1,0,0,0,1
11852,1,0,0,0,0,1
11853,0,1,0,0,0,1
11854,0,1,0,0,0,1
11855,0,0,0,0,1,1
11856,0,0,0,1,0,1
11857,0,0,0,0,1,1
11858,0,0,0,1,0,1
11859,0,0,1,0,0,1
11860,0,0,0,1,0,1
11861,0,1,0,0,0,1
11862,0,1,0,0,0,1
11863,0,0,0,0,1,1
11864,0,0,0,0,1,1
11865,0,0,0,0,1,1
11866,0,1,0,0,0,1
11867,1,0,0,0,0,1
11868,0,1,0,0,0,1
11869,0,1,0,0,0,1
11870,0,0,0,1,0,1
11871,0,0,0,1,0,1
11872,1,0,0,0,0,1
11873,1,0,0,0,0,1
11874,1,0,0,0,0,1
11875,0,0,0,0,1,1
11876,1,0,0,0,0,1
11877,1,0,0,0,0,1
11878,1,0,0,0,0,1
11879,0,0,0,1,0,1
11880,0,0,1,0,0,1
11881,0,1,0,0,0,1
11882,0,1,0,0,0,1
11883,1,0,0,0,0,1
11884,1,0,0,0,0,1
11885,1,0,0,0,0,1
11886,1,0,0,0,0,1
11887,0,0,0,0,1,1
11888,0,0,0,0,1,1
11889,0,0,0,0,1,1
11890,0,1,0,0,0,1
11891,0,0,0,0,1,1
11892,0,0,0,0,1,1
11893,0,0,0,0,1,1
11894,0,1,0,0,0,1
11895,0,1,0,0,0,1
11896,1,0,0,0,0,1
11897,1,0,0,0,0,1
11898,0,1,0,0,0,1
11899,0,1,0,0,0,1
11900,0,0,0,0,1,1
11901,0,0,0,0,1,1
11902,1,0,0,0,0,1
11903,0,0,0,0,1,1
11904,0,1,0,0,0,1
11905,0,1,0,0,0,1
11906,0,0,0,1,0,1
11907,0,1,0,0,0,1
11908,1,0,0,0,0,1
11909,0,1,0,0,0,1
11910,1,0,0,0,0,1
11911,0,1,0,0,0,1
11912,0,1,0,0,0,1
11913,0,1,0,0,0,1
11914,1,0,0,0,0,1
11915,0,1,0,0,0,1
11916,1,0,0,0,0,1
11917,0,1,0,0,0,1
11918,0,0,1,0,0,1
11919,1,0,0,0,0,1
11920,0,0,1,0,0,1
11921,0,0,1,0,0,1
11922,0,0,0,1,0,1
11923,0,0,1,0,0,1
11924,0,0,1,0,0,1
11925,0,0,0,1,0,1
11926,0,1,0,0,0,1
11927,0,0,1,0,0,1
11928,0,1,0,0,0,1
11929,0,0,1,0,0,1
11930,0,0,1,0,0,1
11931,0,0,0,0,1,1
11932,0,0,0,0,1,1
11933,0,0,0,0,1,1
11934,0,1,0,0,0,1
11935,0,1,0,0,0,1
11936,1,0,0,0,0,1
11937,1,0,0,0,0,1
11938,0,0,0,0,1,1
11939,1,0,0,0,0,1
11940,0,0,0,0,1,1
11941,0,0,0,0,1,1
11942,1,0,0,0,0,1
11943,1,0,0,0,0,1
11944,0,1,0,0,0,1
11945,0,0,0,0,1,1
11946,0,0,0,0,1,1
11947,1,0,0,0,0,1
11948,1,0,0,0,0,1
11949,1,0,0,0,0,1
11950,1,0,0,0,0,1
11951,1,0,0,0,0,1
11952,1,0,0,0,0,1
11953,1,0,0,0,0,1
11954,1,0,0,0,0,1
11955,1,0,0,0,0,1
11956,0,0,1,0,0,1
11957,0,0,1,0,0,1
11958,0,0,0,1,0,1
11959,1,0,0,0,0,1
11960,0,0,0,1,0,1
11961,0,0,0,1,0,1
11962,0,0,0,1,0,1
11963,1,0,0,0,0,1
11964,0,0,0,1,0,1
11965,0,0,0,1,0,1
11966,1,0,0,0,0,1
11967,1,0,0,0,0,1
11968,0,0,0,0,1,1
11969,0,0,0,0,1,1
11970,0,0,1,0,0,1
11971,0,0,0,0,1,1
11972,0,1,0,0,0,1
11973,0,0,0,0,1,1
11974,0,0,0,0,1,1
11975,0,0,0,0,1,1
11976,0,0,0,0,1,1
11977,0,0,0,0,1,1
11978,1,0,0,0,0,1
11979,0,1,0,0,0,1
11980,1,0,0,0,0,1
11981,0,1,0,0,0,1
11982,0,0,0,0,1,1
11983,0,0,0,0,1,1
11984,0,0,0,0,1,1
11985,1,0,0,0,0,1
11986,0,1,0,0,0,1
11987,0,1,0,0,0,1
11988,1,0,0,0,0,1
11989,1,0,0,0,0,1
11990,0,0,0,0,1,1
11991,0,0,0,0,1,1
11992,1,0,0,0,0,1
11993,0,1,0,0,0,1
11994,0,0,0,0,1,1
11995,0,1,0,0,0,1
11996,1,0,0,0,0,1
11997,1,0,0,0,0,1
11998,1,0,0,0,0,1
11999,0,0,1,0,0,1
12000,0,0,0,1,0,1
12001,0,0,0,1,0,1
12002,0,0,1,0,0,1
12003,0,0,1,0,0,1
12004,0,0,1,0,0,1
12005,1,0,0,0,0,1
12006,0,0,0,1,0,1
12007,1,0,0,0,0,1
12008,1,0,0,0,0,1
12009,0,0,0,1,0,1
12010,0,0,1,0,0,1
12011,0,0,0,1,0,1
12012,0,0,0,1,0,1
12013,0,0,0,1,0,1
12014,1,0,0,0,0,1
12015,0,0,0,0,1,1
12016,0,1,0,0,0,1
12017,1,0,0,0,0,1
12018,1,0,0,0,0,1
12019,0,0,0,0,1,1
12020,1,0,0,0,0,1
12021,1,0,0,0,0,1
12022,0,0,0,0,1,1
12023,0,1,0,0,0,1
12024,0,1,0,0,0,1
12025,0,1,0,0,0,1
12026,0,0,0,0,1,1
12027,0,1,0,0,0,1
12028,0,1,0,0,0,1
12029,0,0,0,0,1,1
12030,1,0,0,0,0,1
12031,0,1,0,0,0,1
12032,1,0,0,0,0,1
12033,0,0,0,0,1,1
12034,0,1,0,0,0,1
12035,0,0,0,0,1,1
12036,1,0,0,0,0,1
12037,0,1,0,0,0,1
12038,0,1,0,0,0,1
12039,0,0,0,0,1,1
12040,0,0,0,0,1,1
12041,0,1,0,0,0,1
12042,0,1,0,0,0,1
12043,0,0,0,1,0,1
12044,0,1,0,0,0,1
12045,0,1,0,0,0,1
12046,0,0,0,1,0,1
12047,0,1,0,0,0,1
12048,1,0,0,0,0,1
12049,0,0,0,0,1,1
12050,0,1,0,0,0,1
12051,1,0,0,0,0,1
12052,0,0,0,0,1,1
12053,1,0,0,0,0,1
12054,0,0,0,0,1,1
12055,0,1,0,0,0,1
12056,1,0,0,0,0,1
12057,0,0,0,0,1,1
12058,0,0,1,0,0,1
12059,0,0,1,0,0,1
12060,0,1,0,0,0,1
12061,0,1,0,0,0,1
12062,0,1,0,0,0,1
12063,0,0,0,1,0,1
12064,1,0,0,0,0,1
12065,0,0,0,1,0,1
12066,1,0,0,0,0,1
12067,0,1,0,0,0,1
12068,0,1,0,0,0,1
12069,0,1,0,0,0,1
12070,0,0,0,0,1,1
12071,0,0,0,0,1,1
12072,1,0,0,0,0,1
12073,0,1,0,0,0,1
12074,0,1,0,0,0,1
12075,0,0,0,0,1,1
12076,1,0,0,0,0,1
12077,0,0,0,0,1,1
12078,0,0,0,0,1,1
12079,0,1,0,0,0,1
12080,0,1,0,0,0,1
12081,0,1,0,0,0,1
12082,0,0,0,1,0,1
12083,0,0,0,1,0,1
12084,0,0,0,1,0,1
12085,1,0,0,0,0,1
12086,0,1,0,0,0,1
12087,0,1,0,0,0,1
12088,0,0,0,1,0,1
12089,0,0,0,1,0,1
12090,1,0,0,0,0,1
12091,0,0,1,0,0,1
12092,1,0,0,0,0,1
12093,1,0,0,0,0,1
12094,0,0,1,0,0,1
12095,0,1,0,0,0,1
12096,0,1,0,0,0,1
12097,0,0,0,0,1,1
12098,0,0,0,0,1,1
12099,0,0,0,0,1,1
12100,0,0,0,0,1,1
12101,0,1,0,0,0,1
12102,0,0,0,0,1,1
12103,0,1,0,0,0,1
12104,0,0,0,0,1,1
12105,0,0,0,0,1,1
12106,0,0,0,1,0,1
12107,1,0,0,0,0,1
12108,0,1,0,0,0,1
12109,0,1,0,0,0,1
12110,0,0,0,0,1,1
12111,1,0,0,0,0,1
12112,0,0,0,0,1,1
12113,0,0,0,1,0,1
12114,0,1,0,0,0,1
12115,0,0,0,1,0,1
12116,0,1,0,0,0,1
12117,0,1,0,0,0,1
12118,0,0,0,1,0,1
12119,0,1,0,0,0,1
12120,0,0,0,1,0,1
12121,0,0,0,1,0,1
12122,0,0,0,1,0,1
12123,0,0,0,1,0,1
12124,0,0,0,1,0,1
12125,0,1,0,0,0,1
12126,0,0,0,0,1,1
12127,1,0,0,0,0,1
12128,1,0,0,0,0,1
12129,0,1,0,0,0,1
12130,0,0,0,1,0,1
12131,1,0,0,0,0,1
12132,0,1,0,0,0,1
12133,0,1,0,0,0,1
12134,0,1,0,0,0,1
12135,0,1,0,0,0,1
12136,0,0,1,0,0,1
12137,0,0,0,0,1,1
12138,0,0,0,0,1,1
12139,1,0,0,0,0,1
12140,0,1,0,0,0,1
12141,0,0,0,1,0,1
12142,0,1,0,0,0,1
12143,1,0,0,0,0,1
12144,1,0,0,0,0,1
12145,0,0,0,0,1,1
12146,1,0,0,0,0,1
12147,0,0,0,0,1,1
12148,0,1,0,0,0,1
12149,0,0,0,0,1,1
12150,0,1,0,0,0,1
12151,0,0,0,0,1,1
12152,0,1,0,0,0,1
12153,1,0,0,0,0,1
12154,0,0,0,1,0,1
12155,0,1,0,0,0,1
12156,0,1,0,0,0,1
12157,0,0,0,1,0,1
12158,1,0,0,0,0,1
12159,1,0,0,0,0,1
12160,0,0,0,1,0,1
12161,0,1,0,0,0,1
12162,0,1,0,0,0,1
12163,1,0,0,0,0,1
12164,0,0,0,1,0,1
12165,0,0,0,1,0,1
12166,0,1,0,0,0,1
12167,0,1,0,0,0,1
12168,0,1,0,0,0,1
12169,0,0,0,0,1,1
12170,0,1,0,0,0,1
12171,0,1,0,0,0,1
12172,0,1,0,0,0,1
12173,0,0,0,0,1,1
12174,0,0,0,0,1,1
12175,1,0,0,0,0,1
12176,0,1,0,0,0,1
12177,0,1,0,0,0,1
12178,0,1,0,0,0,1
12179,0,0,0,0,1,1
12180,0,0,0,0,1,1
12181,0,0,0,0,1,1
12182,0,1,0,0,0,1
12183,0,0,0,0,1,1
12184,0,1,0,0,0,1
12185,0,0,0,0,1,1
12186,0,0,0,0,1,1
12187,0,0,0,0,1,1
12188,0,0,0,0,1,1
12189,0,0,0,0,1,1
12190,0,1,0,0,0,1
12191,0,0,0,0,1,1
12192,0,1,0,0,0,1
12193,0,1,0,0,0,1
12194,0,1,0,0,0,1
12195,0,0,0,0,1,1
12196,0,1,0,0,0,1
12197,0,1,0,0,0,1
12198,0,1,0,0,0,1
12199,0,1,0,0,0,1
12200,0,0,0,0,1,1
12201,0,0,0,0,1,1
12202,0,0,0,0,1,1
12203,0,0,0,0,1,1
12204,0,0,0,0,1,1
12205,0,0,0,0,1,1
12206,0,1,0,0,0,1
12207,0,0,0,0,1,1
12208,0,0,0,0,1,1
12209,0,0,0,0,1,1
12210,0,0,1,0,0,1
12211,0,0,1,0,0,1
12212,0,1,0,0,0,1
12213,0,0,1,0,0,1
12214,0,0,0,0,1,1
12215,0,1,0,0,0,1
12216,1,0,0,0,0,1
12217,1,0,0,0,0,1
12218,0,0,1,0,0,1
12219,1,0,0,0,0,1
12220,1,0,0,0,0,1
12221,0,0,0,0,1,1
12222,0,0,0,0,1,1
12223,0,0,0,0,1,1
12224,0,0,0,0,1,1
12225,0,0,0,0,1,1
12226,1,0,0,0,0,1
12227,1,0,0,0,0,1
12228,1,0,0,0,0,1
12229,1,0,0,0,0,1
12230,1,0,0,0,0,1
12231,0,0,0,0,1,1
12232,0,0,0,0,1,1
12233,0,0,0,0,1,1
12234,0,1,0,0,0,1
12235,0,1,0,0,0,1
12236,0,1,0,0,0,1
12237,0,1,0,0,0,1
12238,0,1,0,0,0,1
12239,0,1,0,0,0,1
12240,0,0,0,0,1,1
12241,0,0,0,0,1,1
12242,0,0,0,0,1,1
12243,0,1,0,0,0,1
12244,0,1,0,0,0,1
12245,0,1,0,0,0,1
12246,1,0,0,0,0,1
12247,0,1,0,0,0,1
12248,0,1,0,0,0,1
12249,0,1,0,0,0,1
12250,1,0,0,0,0,1
12251,0,0,1,0,0,1
12252,0,1,0,0,0,1
12253,0,1,0,0,0,1
12254,1,0,0,0,0,1
12255,0,0,0,0,1,1
12256,0,0,0,0,1,1
12257,0,1,0,0,0,1
12258,0,0,1,0,0,1
12259,0,1,0,0,0,1
12260,0,0,0,0,1,1
12261,0,0,1,0,0,1
12262,0,1,0,0,0,1
12263,0,0,0,0,1,1
12264,1,0,0,0,0,1
12265,0,0,0,0,1,1
12266,0,1,0,0,0,1
12267,0,1,0,0,0,1
12268,0,1,0,0,0,1
12269,1,0,0,0,0,1
12270,0,1,0,0,0,1
12271,0,1,0,0,0,1
12272,0,1,0,0,0,1
12273,0,1,0,0,0,1
12274,0,1,0,0,0,1
12275,0,1,0,0,0,1
12276,0,1,0,0,0,1
12277,0,0,1,0,0,1
12278,0,0,1,0,0,1
12279,0,1,0,0,0,1
12280,0,0,1,0,0,1
12281,0,0,1,0,0,1
12282,0,1,0,0,0,1
12283,0,1,0,0,0,1
12284,0,1,0,0,0,1
12285,0,1,0,0,0,1
12286,0,0,1,0,0,1
12287,0,1,0,0,0,1
12288,0,0,1,0,0,1
12289,0,1,0,0,0,1
12290,0,1,0,0,0,1
12291,0,0,1,0,0,1
12292,0,0,0,0,1,1
12293,1,0,0,0,0,1
12294,1,0,0,0,0,1
12295,1,0,0,0,0,1
12296,0,0,1,0,0,1
12297,0,0,1,0,0,1
12298,1,0,0,0,0,1
12299,0,0,0,0,1,1
12300,0,0,0,0,1,1
12301,1,0,0,0,0,1
12302,1,0,0,0,0,1
12303,0,0,1,0,0,1
12304,0,1,0,0,0,1
12305,1,0,0,0,0,1
12306,0,1,0,0,0,1
12307,1,0,0,0,0,1
12308,1,0,0,0,0,1
12309,0,1,0,0,0,1
12310,0,0,1,0,0,1
12311,0,1,0,0,0,1
12312,1,0,0,0,0,1
12313,0,0,1,0,0,1
12314,1,0,0,0,0,1
12315,0,1,0,0,0,1
12316,0,1,0,0,0,1
12317,1,0,0,0,0,1
12318,0,1,0,0,0,1
12319,0,1,0,0,0,1
12320,0,1,0,0,0,1
12321,1,0,0,0,0,1
12322,0,1,0,0,0,1
12323,0,1,0,0,0,1
12324,1,0,0,0,0,1
12325,1,0,0,0,0,1
12326,0,1,0,0,0,1
12327,0,1,0,0,0,1
12328,0,1,0,0,0,1
12329,1,0,0,0,0,1
12330,0,0,1,0,0,1
12331,1,0,0,0,0,1
12332,1,0,0,0,0,1
12333,1,0,0,0,0,1
12334,0,0,0,0,1,1
12335,0,0,0,0,1,1
12336,0,0,0,0,1,1
12337,1,0,0,0,0,1
12338,0,1,0,0,0,1
12339,1,0,0,0,0,1
12340,0,0,0,0,1,1
12341,0,0,0,0,1,1
12342,0,0,1,0,0,1
12343,0,0,0,0,1,1
12344,0,0,0,0,1,1
12345,0,1,0,0,0,1
12346,0,0,1,0,0,1
12347,0,1,0,0,0,1
12348,0,1,0,0,0,1
12349,0,1,0,0,0,1
12350,1,0,0,0,0,1
12351,0,0,1,0,0,1
12352,0,0,0,0,1,1
12353,1,0,0,0,0,1
12354,1,0,0,0,0,1
12355,1,0,0,0,0,1
12356,1,0,0,0,0,1
12357,1,0,0,0,0,1
12358,0,1,0,0,0,1
12359,0,0,0,0,1,1
12360,1,0,0,0,0,1
12361,1,0,0,0,0,1
12362,0,1,0,0,0,1
12363,0,0,0,0,1,1
12364,0,0,0,0,1,1
12365,0,0,0,0,1,1
12366,0,0,1,0,0,1
12367,0,0,0,0,1,1
12368,1,0,0,0,0,1
12369,1,0,0,0,0,1
12370,0,1,0,0,0,1
12371,1,0,0,0,0,1
12372,0,1,0,0,0,1
12373,0,1,0,0,0,1
12374,0,0,1,0,0,1
12375,1,0,0,0,0,1
12376,1,0,0,0,0,1
12377,1,0,0,0,0,1
12378,0,0,1,0,0,1
12379,1,0,0,0,0,1
12380,1,0,0,0,0,1
12381,0,0,0,0,1,1
12382,0,0,1,0,0,1
12383,0,0,1,0,0,1
12384,0,0,0,0,1,1
12385,0,0,0,0,1,1
12386,0,1,0,0,0,1
12387,0,1,0,0,0,1
12388,0,0,1,0,0,1
12389,0,1,0,0,0,1
12390,0,1,0,0,0,1
12391,0,0,0,0,1,1
12392,0,0,0,0,1,1
12393,0,1,0,0,0,1
12394,0,1,0,0,0,1
12395,0,1,0,0,0,1
12396,0,1,0,0,0,1
12397,0,0,0,0,1,1
12398,0,0,0,0,1,1
12399,0,1,0,0,0,1
12400,0,1,0,0,0,1
12401,0,1,0,0,0,1
12402,1,0,0,0,0,1
12403,1,0,0,0,0,1
12404,1,0,0,0,0,1
12405,1,0,0,0,0,1
12406,1,0,0,0,0,1
12407,1,0,0,0,0,1
12408,1,0,0,0,0,1
12409,1,0,0,0,0,1
12410,1,0,0,0,0,1
12411,0,1,0,0,0,1
12412,1,0,0,0,0,1
12413,0,1,0,0,0,1
12414,0,1,0,0,0,1
12415,0,1,0,0,0,1
12416,0,1,0,0,0,1
12417,0,1,0,0,0,1
12418,1,0,0,0,0,1
12419,0,0,1,0,0,1
12420,0,1,0,0,0,1
12421,0,1,0,0,0,1
12422,0,1,0,0,0,1
12423,0,0,0,0,1,1
12424,0,0,0,0,1,1
12425,1,0,0,0,0,1
12426,0,1,0,0,0,1
12427,0,0,0,0,1,1
12428,1,0,0,0,0,1
12429,0,0,0,0,1,1
12430,0,1,0,0,0,1
12431,0,1,0,0,0,1
12432,1,0,0,0,0,1
12433,0,1,0,0,0,1
12434,0,1,0,0,0,1
12435,0,0,0,0,1,1
12436,1,0,0,0,0,1
12437,1,0,0,0,0,1
12438,0,1,0,0,0,1
12439,0,1,0,0,0,1
12440,1,0,0,0,0,1
12441,0,1,0,0,0,1
12442,1,0,0,0,0,1
12443,0,0,1,0,0,1
12444,1,0,0,0,0,1
12445,1,0,0,0,0,1
12446,1,0,0,0,0,1
12447,1,0,0,0,0,1
12448,0,1,0,0,0,1
12449,0,1,0,0,0,1
12450,0,1,0,0,0,1
12451,0,1,0,0,0,1
12452,1,0,0,0,0,1
12453,1,0,0,0,0,1
12454,1,0,0,0,0,1
12455,1,0,0,0,0,1
12456,1,0,0,0,0,1
12457,1,0,0,0,0,1
12458,1,0,0,0,0,1
12459,1,0,0,0,0,1
12460,0,0,0,0,1,1
12461,0,1,0,0,0,1
12462,1,0,0,0,0,1
12463,1,0,0,0,0,1
12464,0,1,0,0,0,1
12465,0,1,0,0,0,1
12466,1,0,0,0,0,1
12467,1,0,0,0,0,1
12468,0,1,0,0,0,1
12469,0,1,0,0,0,1
12470,0,0,0,0,1,1
12471,1,0,0,0,0,1
12472,1,0,0,0,0,1
12473,0,1,0,0,0,1
12474,0,1,0,0,0,1
12475,0,0,0,0,1,1
12476,1,0,0,0,0,1
12477,1,0,0,0,0,1
12478,0,1,0,0,0,1
12479,0,1,0,0,0,1
12480,0,0,0,0,1,1
12481,0,0,1,0,0,1
12482,0,0,1,0,0,1
12483,0,0,1,0,0,1
12484,1,0,0,0,0,1
12485,0,1,0,0,0,1
12486,0,1,0,0,0,1
12487,0,0,1,0,0,1
12488,0,0,1,0,0,1
12489,0,0,1,0,0,1
12490,0,0,1,0,0,1
12491,0,1,0,0,0,1
12492,0,1,0,0,0,1
12493,0,0,0,0,1,1
12494,0,0,0,0,1,1
12495,0,0,0,0,1,1
12496,0,0,0,0,1,1
12497,0,0,0,0,1,1
12498,0,1,0,0,0,1
12499,0,1,0,0,0,1
12500,0,0,0,0,1,1
12501,0,0,0,0,1,1
12502,0,0,0,0,1,1
12503,0,1,0,0,0,1
12504,1,0,0,0,0,1
12505,0,1,0,0,0,1
12506,0,1,0,0,0,1
12507,0,1,0,0,0,1
12508,0,1,0,0,0,1
12509,0,1,0,0,0,1
12510,1,0,0,0,0,1
12511,0,1,0,0,0,1
12512,1,0,0,0,0,1
12513,0,1,0,0,0,1
12514,0,1,0,0,0,1
12515,0,1,0,0,0,1
12516,0,0,0,0,1,1
12517,1,0,0,0,0,1
12518,1,0,0,0,0,1
12519,0,0,0,0,1,1
12520,0,0,0,0,1,1
12521,0,1,0,0,0,1
12522,0,0,0,0,1,1
12523,0,0,0,0,1,1
12524,0,1,0,0,0,1
12525,0,0,1,0,0,1
12526,1,0,0,0,0,1
12527,1,0,0,0,0,1
12528,1,0,0,0,0,1
12529,0,0,0,0,1,1
12530,1,0,0,0,0,1
12531,0,1,0,0,0,1
12532,0,0,1,0,0,1
12533,0,0,1,0,0,1
12534,0,0,1,0,0,1
12535,0,0,1,0,0,1
12536,0,1,0,0,0,1
12537,1,0,0,0,0,1
12538,0,0,1,0,0,1
12539,0,0,1,0,0,1
12540,1,0,0,0,0,1
12541,1,0,0,0,0,1
12542,0,0,1,0,0,1
12543,1,0,0,0,0,1
12544,0,0,1,0,0,1
12545,0,0,1,0,0,1
12546,0,0,1,0,0,1
12547,0,0,1,0,0,1
12548,0,0,1,0,0,1
12549,0,0,0,0,1,1
12550,0,1,0,0,0,1
12551,0,1,0,0,0,1
12552,0,1,0,0,0,1
12553,0,0,0,0,1,1
12554,0,0,1,0,0,1
12555,0,0,0,0,1,1
12556,0,0,0,0,1,1
12557,0,1,0,0,0,1
12558,0,1,0,0,0,1
12559,0,1,0,0,0,1
12560,0,0,0,0,1,1
12561,0,1,0,0,0,1
12562,1,0,0,0,0,1
12563,0,1,0,0,0,1
12564,1,0,0,0,0,1
12565,0,1,0,0,0,1
12566,1,0,0,0,0,1
12567,0,1,0,0,0,1
12568,0,1,0,0,0,1
12569,0,1,0,0,0,1
12570,0,0,0,0,1,1
12571,1,0,0,0,0,1
12572,0,0,1,0,0,1
12573,0,0,0,1,0,1
12574,0,1,0,0,0,1
12575,0,1,0,0,0,1
12576,0,0,0,1,0,1
12577,0,0,0,1,0,1
12578,0,0,0,1,0,1
12579,0,1,0,0,0,1
12580,0,1,0,0,0,1
12581,0,1,0,0,0,1
12582,0,1,0,0,0,1
12583,0,1,0,0,0,1
12584,0,1,0,0,0,1
12585,0,1,0,0,0,1
12586,0,0,1,0,0,1
12587,0,0,1,0,0,1
12588,1,0,0,0,0,1
12589,0,0,1,0,0,1
12590,0,0,1,0,0,1
12591,0,0,1,0,0,1
12592,0,0,1,0,0,1
12593,0,0,1,0,0,1
12594,0,0,1,0,0,1
12595,0,0,1,0,0,1
12596,0,0,1,0,0,1
12597,0,0,0,1,0,1
12598,0,0,0,0,1,1
12599,1,0,0,0,0,1
12600,0,0,0,0,1,1
12601,1,0,0,0,0,1
12602,0,0,0,0,1,1
12603,0,1,0,0,0,1
12604,0,1,0,0,0,1
12605,1,0,0,0,0,1
12606,0,0,0,0,1,1
12607,0,1,0,0,0,1
12608,0,1,0,0,0,1
12609,0,0,1,0,0,1
12610,0,0,1,0,0,1
12611,0,0,0,0,1,1
12612,0,0,0,0,1,1
12613,1,0,0,0,0,1
12614,0,1,0,0,0,1
12615,1,0,0,0,0,1
12616,1,0,0,0,0,1
12617,0,1,0,0,0,1
12618,0,1,0,0,0,1
12619,1,0,0,0,0,1
12620,1,0,0,0,0,1
12621,0,0,1,0,0,1
12622,0,0,0,1,0,1
12623,0,0,0,1,0,1
12624,0,0,1,0,0,1
12625,0,1,0,0,0,1
12626,0,1,0,0,0,1
12627,1,0,0,0,0,1
12628,1,0,0,0,0,1
12629,1,0,0,0,0,1
12630,1,0,0,0,0,1
12631,0,0,1,0,0,1
12632,1,0,0,0,0,1
12633,0,0,0,1,0,1
12634,0,0,0,1,0,1
12635,0,0,0,1,0,1
12636,0,0,0,1,0,1
12637,0,0,0,1,0,1
12638,1,0,0,0,0,1
12639,1,0,0,0,0,1
12640,1,0,0,0,0,1
12641,1,0,0,0,0,1
12642,1,0,0,0,0,1
12643,1,0,0,0,0,1
12644,1,0,0,0,0,1
12645,1,0,0,0,0,1
12646,1,0,0,0,0,1
12647,0,1,0,0,0,1
12648,0,1,0,0,0,1
12649,0,1,0,0,0,1
12650,0,1,0,0,0,1
12651,1,0,0,0,0,1
12652,1,0,0,0,0,1
12653,0,1,0,0,0,1
12654,0,0,0,1,0,1
12655,0,0,0,1,0,1
12656,0,0,0,1,0,1
12657,0,0,0,1,0,1
12658,0,0,0,1,0,1
12659,1,0,0,0,0,1
12660,0,0,0,1,0,1
12661,1,0,0,0,0,1
12662,1,0,0,0,0,1
12663,1,0,0,0,0,1
12664,1,0,0,0,0,1
12665,0,0,0,0,1,1
12666,1,0,0,0,0,1
12667,1,0,0,0,0,1
12668,0,0,1,0,0,1
12669,1,0,0,0,0,1
12670,1,0,0,0,0,1
12671,1,0,0,0,0,1
12672,0,1,0,0,0,1
12673,0,1,0,0,0,1
12674,1,0,0,0,0,1
12675,1,0,0,0,0,1
12676,0,1,0,0,0,1
12677,1,0,0,0,0,1
12678,0,1,0,0,0,1
12679,0,1,0,0,0,1
12680,0,1,0,0,0,1
12681,0,1,0,0,0,1
12682,0,1,0,0,0,1
12683,0,1,0,0,0,1
12684,0,1,0,0,0,1
12685,0,1,0,0,0,1
12686,0,1,0,0,0,1
12687,0,1,0,0,0,1
12688,0,1,0,0,0,1
12689,1,0,0,0,0,1
12690,0,1,0,0,0,1
12691,0,1,0,0,0,1
12692,1,0,0,0,0,1
12693,0,0,1,0,0,1
12694,0,1,0,0,0,1
12695,1,0,0,0,0,1
12696,1,0,0,0,0,1
12697,1,0,0,0,0,1
12698,0,1,0,0,0,1
12699,1,0,0,0,0,1
12700,1,0,0,0,0,1
12701,1,0,0,0,0,1
12702,1,0,0,0,0,1
12703,1,0,0,0,0,1
12704,0,1,0,0,0,1
12705,0,0,1,0,0,1
12706,0,0,0,0,1,1
12707,0,1,0,0,0,1
12708,0,0,0,0,1,1
12709,0,0,1,0,0,1
12710,1,0,0,0,0,1
12711,1,0,0,0,0,1
12712,1,0,0,0,0,1
12713,1,0,0,0,0,1
12714,1,0,0,0,0,1
12715,1,0,0,0,0,1
12716,0,0,0,0,1,1
12717,0,1,0,0,0,1
12718,0,0,0,1,0,1
12719,0,1,0,0,0,1
12720,0,1,0,0,0,1
12721,0,1,0,0,0,1
12722,0,0,0,0,1,1
12723,1,0,0,0,0,1
12724,0,0,0,0,1,1
12725,1,0,0,0,0,1
12726,0,1,0,0,0,1
12727,0,1,0,0,0,1
12728,0,1,0,0,0,1
12729,0,1,0,0,0,1
12730,0,1,0,0,0,1
12731,0,1,0,0,0,1
12732,0,1,0,0,0,1
12733,0,1,0,0,0,1
12734,0,0,0,1,0,1
12735,0,0,0,1,0,1
12736,0,1,0,0,0,1
12737,0,1,0,0,0,1
12738,0,1,0,0,0,1
12739,1,0,0,0,0,1
12740,0,1,0,0,0,1
12741,1,0,0,0,0,1
12742,0,0,0,1,0,1
12743,0,0,0,1,0,1
12744,0,0,1,0,0,1
12745,1,0,0,0,0,1
12746,1,0,0,0,0,1
12747,1,0,0,0,0,1
12748,1,0,0,0,0,1
12749,0,1,0,0,0,1
12750,0,0,1,0,0,1
12751,0,0,1,0,0,1
12752,1,0,0,0,0,1
12753,1,0,0,0,0,1
12754,1,0,0,0,0,1
12755,0,1,0,0,0,1
12756,0,0,0,0,1,1
12757,0,0,0,0,1,1
12758,0,0,0,0,1,1
12759,0,0,0,0,1,1
12760,1,0,0,0,0,1
12761,1,0,0,0,0,1
12762,1,0,0,0,0,1
12763,0,0,0,0,1,1
12764,1,0,0,0,0,1
12765,0,1,0,0,0,1
12766,0,1,0,0,0,1
12767,1,0,0,0,0,1
12768,0,1,0,0,0,1
12769,0,0,0,1,0,1
12770,1,0,0,0,0,1
12771,1,0,0,0,0,1
12772,1,0,0,0,0,1
12773,1,0,0,0,0,1
12774,1,0,0,0,0,1
12775,1,0,0,0,0,1
12776,0,1,0,0,0,1
12777,1,0,0,0,0,1
12778,0,1,0,0,0,1
12779,0,0,0,1,0,1
12780,0,0,0,1,0,1
12781,0,1,0,0,0,1
12782,0,0,0,1,0,1
12783,0,0,0,1,0,1
12784,1,0,0,0,0,1
12785,1,0,0,0,0,1
12786,0,0,0,0,1,1
12787,0,1,0,0,0,1
12788,0,1,0,0,0,1
12789,1,0,0,0,0,1
12790,1,0,0,0,0,1
12791,0,1,0,0,0,1
12792,0,0,0,0,1,1
12793,0,1,0,0,0,1
12794,1,0,0,0,0,1
12795,0,1,0,0,0,1
12796,1,0,0,0,0,1
12797,0,1,0,0,0,1
12798,0,1,0,0,0,1
12799,0,1,0,0,0,1
12800,1,0,0,0,0,1
12801,0,1,0,0,0,1
12802,0,1,0,0,0,1
12803,0,0,0,0,1,1
12804,0,1,0,0,0,1
12805,0,1,0,0,0,1
12806,1,0,0,0,0,1
12807,0,0,0,0,1,1
12808,0,0,1,0,0,1
12809,0,0,0,1,0,1
12810,1,0,0,0,0,1
12811,0,0,0,1,0,1
12812,0,0,0,1,0,1
12813,1,0,0,0,0,1
12814,0,0,0,1,0,1
12815,0,1,0,0,0,1
12816,1,0,0,0,0,1
12817,1,0,0,0,0,1
12818,0,1,0,0,0,1
12819,0,1,0,0,0,1
12820,0,1,0,0,0,1
12821,1,0,0,0,0,1
12822,0,1,0,0,0,1
12823,0,1,0,0,0,1
12824,0,1,0,0,0,1
12825,0,1,0,0,0,1
12826,0,1,0,0,0,1
12827,1,0,0,0,0,1
12828,0,1,0,0,0,1
12829,1,0,0,0,0,1
12830,0,1,0,0,0,1
12831,1,0,0,0,0,1
12832,0,1,0,0,0,1
12833,0,1,0,0,0,1
12834,0,0,0,1,0,1
12835,0,0,0,1,0,1
12836,0,0,0,1,0,1
12837,0,0,0,1,0,1
12838,0,0,0,1,0,1
12839,0,0,0,1,0,1
12840,0,0,0,1,0,1
12841,0,0,0,1,0,1
12842,1,0,0,0,0,1
12843,0,0,0,1,0,1
12844,0,0,0,1,0,1
12845,1,0,0,0,0,1
12846,0,0,0,0,1,1
12847,0,0,0,0,1,1
12848,0,0,0,1,0,1
12849,1,0,0,0,0,1
12850,1,0,0,0,0,1
12851,0,0,0,0,1,1
12852,1,0,0,0,0,1
12853,1,0,0,0,0,1
12854,1,0,0,0,0,1
12855,1,0,0,0,0,1
12856,0,1,0,0,0,1
12857,0,0,0,0,1,1
12858,0,1,0,0,0,1
12859,0,1,0,0,0,1
12860,1,0,0,0,0,1
12861,1,0,0,0,0,1
12862,1,0,0,0,0,1
12863,0,1,0,0,0,1
12864,0,1,0,0,0,1
12865,1,0,0,0,0,1
12866,0,1,0,0,0,1
12867,0,0,0,1,0,1
12868,0,1,0,0,0,1
12869,0,1,0,0,0,1
12870,0,1,0,0,0,1
12871,0,1,0,0,0,1
12872,0,1,0,0,0,1
12873,0,1,0,0,0,1
12874,0,1,0,0,0,1
12875,0,1,0,0,0,1
12876,1,0,0,0,0,1
12877,0,1,0,0,0,1
12878,0,1,0,0,0,1
12879,0,1,0,0,0,1
12880,1,0,0,0,0,1
12881,1,0,0,0,0,1
12882,1,0,0,0,0,1
12883,1,0,0,0,0,1
12884,0,1,0,0,0,1
12885,1,0,0,0,0,1
12886,0,1,0,0,0,1
12887,0,0,0,0,1,1
12888,0,0,1,0,0,1
12889,1,0,0,0,0,1
12890,0,0,1,0,0,1
12891,1,0,0,0,0,1
12892,1,0,0,0,0,1
12893,0,0,1,0,0,1
12894,1,0,0,0,0,1
12895,1,0,0,0,0,1
12896,1,0,0,0,0,1
12897,1,0,0,0,0,1
12898,1,0,0,0,0,1
12899,0,1,0,0,0,1
12900,1,0,0,0,0,1
12901,1,0,0,0,0,1
12902,1,0,0,0,0,1
12903,0,0,1,0,0,1
12904,0,1,0,0,0,1
12905,0,0,0,0,1,1
12906,0,1,0,0,0,1
12907,0,0,0,0,1,1
12908,0,1,0,0,0,1
12909,0,1,0,0,0,1
12910,1,0,0,0,0,1
12911,0,1,0,0,0,1
12912,0,0,1,0,0,1
12913,1,0,0,0,0,1
12914,1,0,0,0,0,1
12915,1,0,0,0,0,1
12916,0,1,0,0,0,1
12917,0,1,0,0,0,1
12918,0,1,0,0,0,1
12919,0,0,1,0,0,1
12920,0,1,0,0,0,1
12921,0,1,0,0,0,1
12922,0,1,0,0,0,1
12923,1,0,0,0,0,1
12924,0,1,0,0,0,1
12925,0,1,0,0,0,1
12926,1,0,0,0,0,1
12927,1,0,0,0,0,1
12928,0,1,0,0,0,1
12929,0,1,0,0,0,1
12930,0,1,0,0,0,1
12931,1,0,0,0,0,1
12932,0,0,0,0,1,1
12933,1,0,0,0,0,1
12934,0,0,1,0,0,1
12935,0,0,1,0,0,1
12936,1,0,0,0,0,1
12937,1,0,0,0,0,1
12938,1,0,0,0,0,1
12939,0,0,1,0,0,1
12940,0,0,1,0,0,1
12941,1,0,0,0,0,1
12942,0,0,0,0,1,1
12943,0,0,0,1,0,1
12944,0,0,0,1,0,1
12945,0,1,0,0,0,1
12946,1,0,0,0,0,1
12947,0,1,0,0,0,1
12948,0,1,0,0,0,1
12949,0,1,0,0,0,1
12950,0,0,0,0,1,1
12951,1,0,0,0,0,1
12952,0,1,0,0,0,1
12953,0,0,0,0,1,1
12954,0,1,0,0,0,1
12955,0,0,1,0,0,1
12956,0,0,0,1,0,1
12957,0,0,0,1,0,1
12958,0,0,1,0,0,1
12959,0,0,0,0,1,1
12960,0,1,0,0,0,1
12961,0,0,0,0,1,1
12962,0,0,0,1,0,1
12963,0,1,0,0,0,1
12964,0,1,0,0,0,1
12965,0,0,0,1,0,1
12966,0,0,0,0,1,1
12967,0,1,0,0,0,1
12968,0,1,0,0,0,1
12969,0,0,0,1,0,1
12970,1,0,0,0,0,1
12971,1,0,0,0,0,1
12972,0,0,1,0,0,1
12973,0,1,0,0,0,1
12974,0,0,0,0,1,1
12975,0,1,0,0,0,1
12976,0,0,0,0,1,1
12977,0,1,0,0,0,1
12978,0,1,0,0,0,1
12979,0,0,0,1,0,1
12980,0,0,0,1,0,1
12981,0,1,0,0,0,1
12982,0,1,0,0,0,1
12983,0,0,0,0,1,1
12984,0,1,0,0,0,1
12985,0,1,0,0,0,1
12986,0,0,0,1,0,1
12987,0,0,0,1,0,1
12988,0,1,0,0,0,1
12989,0,1,0,0,0,1
12990,0,1,0,0,0,1
12991,0,1,0,0,0,1
12992,1,0,0,0,0,1
12993,0,1,0,0,0,1
12994,1,0,0,0,0,1
12995,0,0,0,0,1,1
12996,0,1,0,0,0,1
12997,0,1,0,0,0,1
12998,0,0,0,0,1,1
12999,0,0,0,0,1,1
13000,0,0,0,0,1,1
13001,0,1,0,0,0,1
13002,0,0,1,0,0,1
13003,1,0,0,0,0,1
13004,1,0,0,0,0,1
13005,0,1,0,0,0,1
13006,0,0,0,1,0,1
13007,1,0,0,0,0,1
13008,0,0,1,0,0,1
13009,0,1,0,0,0,1
13010,1,0,0,0,0,1
13011,1,0,0,0,0,1
13012,1,0,0,0,0,1
13013,0,1,0,0,0,1
13014,1,0,0,0,0,1
13015,1,0,0,0,0,1
13016,0,1,0,0,0,1
13017,0,0,1,0,0,1
13018,0,0,1,0,0,1
13019,0,0,1,0,0,1
13020,1,0,0,0,0,1
13021,1,0,0,0,0,1
13022,0,1,0,0,0,1
13023,0,0,1,0,0,1
13024,0,1,0,0,0,1
13025,0,1,0,0,0,1
13026,1,0,0,0,0,1
13027,0,0,0,0,1,1
13028,0,0,1,0,0,1
13029,0,0,0,0,1,1
13030,1,0,0,0,0,1
13031,1,0,0,0,0,1
13032,0,1,0,0,0,1
13033,1,0,0,0,0,1
13034,0,1,0,0,0,1
13035,0,0,0,1,0,1
13036,0,0,0,1,0,1
13037,0,1,0,0,0,1
13038,1,0,0,0,0,1
13039,0,1,0,0,0,1
13040,0,0,0,1,0,1
13041,0,0,0,1,0,1
13042,0,1,0,0,0,1
13043,1,0,0,0,0,1
13044,0,1,0,0,0,1
13045,0,0,0,0,1,1
13046,0,0,0,0,1,1
13047,0,0,0,0,1,1
13048,0,1,0,0,0,1
13049,0,0,0,1,0,1
13050,0,1,0,0,0,1
13051,0,0,0,1,0,1
13052,0,0,0,1,0,1
13053,0,0,0,1,0,1
13054,1,0,0,0,0,1
13055,0,0,0,0,1,1
13056,0,1,0,0,0,1
13057,0,0,1,0,0,1
13058,0,1,0,0,0,1
13059,0,1,0,0,0,1
13060,0,0,1,0,0,1
13061,0,0,0,0,1,1
13062,0,0,0,0,1,1
13063,0,0,0,0,1,1
13064,0,1,0,0,0,1
13065,0,1,0,0,0,1
13066,0,0,0,0,1,1
13067,1,0,0,0,0,1
13068,0,1,0,0,0,1
13069,0,1,0,0,0,1
13070,0,1,0,0,0,1
13071,0,1,0,0,0,1
13072,0,1,0,0,0,1
13073,0,1,0,0,0,1
13074,1,0,0,0,0,1
13075,0,1,0,0,0,1
13076,0,1,0,0,0,1
13077,0,1,0,0,0,1
13078,0,1,0,0,0,1
13079,0,1,0,0,0,1
13080,0,1,0,0,0,1
13081,0,1,0,0,0,1
13082,0,0,0,0,1,1
13083,0,0,0,0,1,1
13084,0,1,0,0,0,1
13085,0,0,1,0,0,1
13086,1,0,0,0,0,1
13087,0,1,0,0,0,1
13088,0,1,0,0,0,1
13089,0,1,0,0,0,1
13090,0,0,0,0,1,1
13091,0,1,0,0,0,1
13092,1,0,0,0,0,1
13093,0,1,0,0,0,1
13094,0,1,0,0,0,1
13095,0,1,0,0,0,1
13096,0,1,0,0,0,1
13097,0,0,0,0,1,1
13098,0,0,1,0,0,1
13099,0,0,0,0,1,1
13100,0,1,0,0,0,1
13101,0,0,1,0,0,1
13102,0,0,1,0,0,1
13103,0,1,0,0,0,1
13104,0,0,0,1,0,1
13105,0,0,0,1,0,1
13106,0,0,0,1,0,1
13107,0,1,0,0,0,1
13108,0,0,0,1,0,1
13109,0,1,0,0,0,1
13110,0,0,0,1,0,1
13111,0,1,0,0,0,1
13112,0,1,0,0,0,1
13113,0,1,0,0,0,1
13114,1,0,0,0,0,1
13115,1,0,0,0,0,1
13116,1,0,0,0,0,1
13117,1,0,0,0,0,1
13118,1,0,0,0,0,1
13119,1,0,0,0,0,1
13120,1,0,0,0,0,1
13121,1,0,0,0,0,1
13122,0,1,0,0,0,1
13123,0,0,0,0,1,1
13124,0,1,0,0,0,1
13125,0,1,0,0,0,1
13126,0,0,0,0,1,1
13127,0,0,0,0,1,1
13128,0,0,0,0,1,1
13129,0,1,0,0,0,1
13130,0,0,0,0,1,1
13131,0,1,0,0,0,1
13132,0,0,0,0,1,1
13133,0,0,0,0,1,1
13134,0,1,0,0,0,1
13135,0,0,0,0,1,1
13136,0,0,0,0,1,1
13137,0,1,0,0,0,1
13138,0,1,0,0,0,1
13139,0,0,0,0,1,1
13140,0,0,0,0,1,1
13141,1,0,0,0,0,1
13142,0,1,0,0,0,1
13143,0,0,0,0,1,1
13144,0,0,1,0,0,1
13145,0,0,0,0,1,1
13146,0,0,0,0,1,1
13147,0,1,0,0,0,1
13148,0,0,0,1,0,1
13149,0,0,0,0,1,1
13150,0,0,0,1,0,1
13151,0,0,0,1,0,1
13152,0,0,0,0,1,1
13153,0,0,0,0,1,1
13154,0,0,1,0,0,1
13155,0,1,0,0,0,1
13156,0,1,0,0,0,1
13157,0,0,0,0,1,1
13158,0,1,0,0,0,1
13159,1,0,0,0,0,1
13160,0,0,0,0,1,1
13161,0,0,0,0,1,1
13162,1,0,0,0,0,1
13163,1,0,0,0,0,1
13164,1,0,0,0,0,1
13165,1,0,0,0,0,1
13166,0,0,0,1,0,1
13167,1,0,0,0,0,1
13168,0,0,0,1,0,1
13169,0,0,0,1,0,1
13170,0,0,0,1,0,1
13171,0,0,0,1,0,1
13172,0,0,0,1,0,1
13173,0,0,0,1,0,1
13174,0,0,1,0,0,1
13175,0,1,0,0,0,1
13176,0,0,1,0,0,1
13177,0,0,1,0,0,1
13178,1,0,0,0,0,1
13179,0,0,0,0,1,1
13180,0,0,0,0,1,1
13181,0,1,0,0,0,1
13182,0,0,0,0,1,1
13183,0,1,0,0,0,1
13184,0,1,0,0,0,1
13185,0,0,0,0,1,1
13186,0,1,0,0,0,1
13187,0,1,0,0,0,1
13188,0,1,0,0,0,1
13189,0,0,0,0,1,1
13190,0,0,0,0,1,1
13191,0,1,0,0,0,1
13192,0,1,0,0,0,1
13193,0,1,0,0,0,1
13194,0,1,0,0,0,1
13195,0,1,0,0,0,1
13196,1,0,0,0,0,1
13197,1,0,0,0,0,1
13198,0,0,0,0,1,1
13199,0,0,0,1,0,1
13200,0,1,0,0,0,1
13201,0,0,0,0,1,1
13202,0,1,0,0,0,1
13203,0,1,0,0,0,1
13204,0,1,0,0,0,1
13205,1,0,0,0,0,1
13206,1,0,0,0,0,1
13207,1,0,0,0,0,1
13208,1,0,0,0,0,1
13209,1,0,0,0,0,1
13210,1,0,0,0,0,1
13211,0,0,0,1,0,1
13212,0,0,0,1,0,1
13213,0,0,0,1,0,1
13214,0,0,0,1,0,1
13215,0,0,0,1,0,1
13216,0,0,0,1,0,1
13217,1,0,0,0,0,1
13218,1,0,0,0,0,1
13219,1,0,0,0,0,1
13220,1,0,0,0,0,1
13221,0,0,0,1,0,1
13222,0,0,1,0,0,1
13223,0,0,0,0,1,1
13224,0,1,0,0,0,1
13225,1,0,0,0,0,1
13226,0,0,0,0,1,1
13227,0,0,0,0,1,1
13228,1,0,0,0,0,1
13229,1,0,0,0,0,1
13230,0,0,0,1,0,1
13231,0,0,0,1,0,1
13232,1,0,0,0,0,1
13233,0,0,0,0,1,1
13234,0,0,0,0,1,1
13235,0,1,0,0,0,1
13236,0,1,0,0,0,1
13237,0,0,0,0,1,1
13238,0,0,0,0,1,1
13239,0,1,0,0,0,1
13240,0,1,0,0,0,1
13241,0,1,0,0,0,1
13242,0,0,0,0,1,1
13243,1,0,0,0,0,1
13244,0,0,0,0,1,1
13245,0,0,0,0,1,1
13246,0,1,0,0,0,1
13247,0,1,0,0,0,1
13248,0,1,0,0,0,1
13249,0,0,0,0,1,1
13250,0,1,0,0,0,1
13251,0,1,0,0,0,1
13252,0,1,0,0,0,1
13253,1,0,0,0,0,1
13254,0,1,0,0,0,1
13255,0,0,0,0,1,1
13256,0,1,0,0,0,1
13257,0,1,0,0,0,1
13258,1,0,0,0,0,1
13259,0,0,0,0,1,1
13260,0,0,0,0,1,1
13261,0,1,0,0,0,1
13262,1,0,0,0,0,1
13263,0,0,1,0,0,1
13264,0,0,0,1,0,1
13265,1,0,0,0,0,1
13266,1,0,0,0,0,1
13267,0,0,0,1,0,1
13268,0,0,1,0,0,1
13269,0,0,1,0,0,1
13270,0,0,0,1,0,1
13271,1,0,0,0,0,1
13272,0,0,1,0,0,1
13273,0,1,0,0,0,1
13274,0,0,0,0,1,1
13275,0,1,0,0,0,1
13276,0,1,0,0,0,1
13277,0,1,0,0,0,1
13278,0,1,0,0,0,1
13279,0,1,0,0,0,1
13280,0,0,0,0,1,1
13281,0,0,0,0,1,1
13282,0,1,0,0,0,1
13283,0,0,0,0,1,1
13284,0,0,0,0,1,1
13285,0,0,0,0,1,1
13286,0,1,0,0,0,1
13287,0,1,0,0,0,1
13288,0,1,0,0,0,1
13289,0,1,0,0,0,1
13290,0,1,0,0,0,1
13291,0,1,0,0,0,1
13292,0,1,0,0,0,1
13293,0,1,0,0,0,1
13294,1,0,0,0,0,1
13295,1,0,0,0,0,1
13296,0,0,0,0,1,1
13297,0,0,0,0,1,1
13298,1,0,0,0,0,1
13299,1,0,0,0,0,1
13300,0,0,0,0,1,1
13301,0,1,0,0,0,1
13302,0,1,0,0,0,1
13303,0,0,0,0,1,1
13304,0,1,0,0,0,1
13305,0,1,0,0,0,1
13306,0,1,0,0,0,1
13307,0,0,0,0,1,1
13308,1,0,0,0,0,1
13309,0,1,0,0,0,1
13310,0,1,0,0,0,1
13311,0,1,0,0,0,1
13312,1,0,0,0,0,1
13313,0,1,0,0,0,1
13314,0,0,1,0,0,1
13315,0,0,1,0,0,1
13316,1,0,0,0,0,1
13317,0,1,0,0,0,1
13318,1,0,0,0,0,1
13319,0,0,1,0,0,1
13320,0,0,1,0,0,1
13321,1,0,0,0,0,1
13322,1,0,0,0,0,1
13323,1,0,0,0,0,1
13324,0,0,1,0,0,1
13325,0,0,1,0,0,1
13326,1,0,0,0,0,1
13327,1,0,0,0,0,1
13328,0,0,0,0,1,1
13329,0,0,0,0,1,1
13330,0,0,0,0,1,1
13331,0,0,1,0,0,1
13332,0,0,1,0,0,1
13333,0,0,0,0,1,1
13334,1,0,0,0,0,1
13335,0,1,0,0,0,1
13336,0,0,0,0,1,1
13337,0,1,0,0,0,1
13338,0,0,0,0,1,1
13339,0,0,0,0,1,1
13340,0,1,0,0,0,1
13341,0,0,0,0,1,1
13342,0,0,0,0,1,1
13343,0,0,0,0,1,1
13344,0,0,0,0,1,1
13345,0,1,0,0,0,1
13346,0,0,0,1,0,1
13347,0,1,0,0,0,1
13348,0,1,0,0,0,1
13349,0,0,0,1,0,1
13350,0,1,0,0,0,1
13351,0,1,0,0,0,1
13352,0,1,0,0,0,1
13353,0,1,0,0,0,1
13354,0,1,0,0,0,1
13355,0,0,0,1,0,1
13356,0,0,1,0,0,1
13357,0,0,1,0,0,1
13358,0,1,0,0,0,1
13359,0,0,0,0,1,1
13360,1,0,0,0,0,1
13361,0,0,0,0,1,1
13362,0,0,0,0,1,1
13363,1,0,0,0,0,1
13364,0,0,1,0,0,1
13365,0,0,0,0,1,1
13366,0,0,1,0,0,1
13367,0,0,0,0,1,1
13368,0,0,0,0,1,1
13369,0,0,0,1,0,1
13370,0,0,0,1,0,1
13371,0,0,0,0,1,1
13372,0,1,0,0,0,1
13373,0,1,0,0,0,1
13374,0,0,0,1,0,1
13375,0,1,0,0,0,1
13376,0,1,0,0,0,1
13377,0,0,0,0,1,1
13378,0,0,0,0,1,1
13379,0,0,0,0,1,1
13380,0,0,0,0,1,1
13381,1,0,0,0,0,1
13382,0,0,0,0,1,1
13383,1,0,0,0,0,1
13384,0,0,0,0,1,1
13385,0,0,0,0,1,1
13386,0,0,0,0,1,1
13387,0,1,0,0,0,1
13388,0,0,0,0,1,1
13389,0,1,0,0,0,1
13390,0,1,0,0,0,1
13391,0,1,0,0,0,1
13392,0,1,0,0,0,1
13393,0,1,0,0,0,1
13394,0,1,0,0,0,1
13395,0,1,0,0,0,1
13396,0,0,0,1,0,1
13397,0,0,0,1,0,1
13398,0,1,0,0,0,1
13399,0,0,0,1,0,1
13400,0,1,0,0,0,1
13401,0,1,0,0,0,1
13402,0,1,0,0,0,1
13403,0,0,1,0,0,1
13404,0,0,1,0,0,1
13405,0,1,0,0,0,1
13406,0,1,0,0,0,1
13407,0,1,0,0,0,1
13408,1,0,0,0,0,1
13409,1,0,0,0,0,1
13410,0,0,0,0,1,1
13411,0,0,0,0,1,1
13412,0,0,0,0,1,1
13413,0,0,0,0,1,1
13414,0,0,0,0,1,1
13415,0,0,1,0,0,1
13416,1,0,0,0,0,1
13417,1,0,0,0,0,1
13418,0,0,0,0,1,1
13419,0,0,0,0,1,1
13420,0,1,0,0,0,1
13421,0,0,0,0,1,1
13422,1,0,0,0,0,1
13423,0,0,0,0,1,1
13424,0,0,0,0,1,1
13425,1,0,0,0,0,1
13426,0,0,0,0,1,1
13427,0,1,0,0,0,1
13428,0,0,0,1,0,1
13429,0,0,0,1,0,1
13430,0,1,0,0,0,1
13431,0,1,0,0,0,1
13432,0,1,0,0,0,1
13433,0,1,0,0,0,1
13434,0,1,0,0,0,1
13435,1,0,0,0,0,1
13436,0,0,0,1,0,1
13437,0,0,0,1,0,1
13438,0,0,0,1,0,1
13439,1,0,0,0,0,1
13440,0,0,0,0,1,1
13441,1,0,0,0,0,1
13442,0,0,0,0,1,1
13443,0,0,0,0,1,1
13444,1,0,0,0,0,1
13445,0,0,1,0,0,1
13446,0,0,0,0,1,1
13447,1,0,0,0,0,1
13448,1,0,0,0,0,1
13449,1,0,0,0,0,1
13450,1,0,0,0,0,1
13451,1,0,0,0,0,1
13452,0,0,0,0,1,1
13453,0,1,0,0,0,1
13454,0,1,0,0,0,1
13455,0,1,0,0,0,1
13456,0,1,0,0,0,1
13457,0,1,0,0,0,1
13458,0,1,0,0,0,1
13459,1,0,0,0,0,1
13460,0,1,0,0,0,1
13461,0,0,0,1,0,1
13462,0,0,0,0,1,1
13463,0,1,0,0,0,1
13464,0,0,0,1,0,1
13465,0,1,0,0,0,1
13466,0,0,0,1,0,1
13467,0,1,0,0,0,1
13468,0,0,0,0,1,1
13469,0,0,1,0,0,1
13470,0,0,0,0,1,1
13471,1,0,0,0,0,1
13472,0,0,0,0,1,1
13473,0,0,0,1,0,1
13474,0,0,0,1,0,1
13475,0,0,0,0,1,1
13476,0,1,0,0,0,1
13477,0,0,0,0,1,1
13478,0,0,0,0,1,1
13479,0,1,0,0,0,1
13480,0,0,0,0,1,1
13481,0,0,0,0,1,1
13482,0,0,0,0,1,1
13483,1,0,0,0,0,1
13484,0,1,0,0,0,1
13485,1,0,0,0,0,1
13486,1,0,0,0,0,1
13487,0,1,0,0,0,1
13488,1,0,0,0,0,1
13489,0,1,0,0,0,1
13490,0,1,0,0,0,1
13491,1,0,0,0,0,1
13492,0,1,0,0,0,1
13493,0,1,0,0,0,1
13494,0,1,0,0,0,1
13495,0,1,0,0,0,1
13496,0,0,0,0,1,1
13497,0,0,0,0,1,1
13498,1,0,0,0,0,1
13499,1,0,0,0,0,1
13500,0,0,0,0,1,1
13501,0,1,0,0,0,1
13502,0,0,0,0,1,1
13503,0,1,0,0,0,1
13504,0,0,0,0,1,1
13505,0,1,0,0,0,1
13506,0,1,0,0,0,1
13507,0,0,0,0,1,1
13508,0,0,0,0,1,1
13509,0,0,0,0,1,1
13510,0,1,0,0,0,1
13511,0,0,0,0,1,1
13512,0,0,0,0,1,1
13513,0,0,0,0,1,1
13514,0,0,0,0,1,1
13515,1,0,0,0,0,1
13516,1,0,0,0,0,1
13517,1,0,0,0,0,1
13518,0,1,0,0,0,1
13519,1,0,0,0,0,1
13520,0,1,0,0,0,1
13521,1,0,0,0,0,1
13522,0,0,0,0,1,1
13523,0,0,0,1,0,1
13524,1,0,0,0,0,1
13525,1,0,0,0,0,1
13526,0,1,0,0,0,1
13527,1,0,0,0,0,1
13528,1,0,0,0,0,1
13529,0,1,0,0,0,1
13530,1,0,0,0,0,1
13531,0,0,0,1,0,1
13532,0,0,0,1,0,1
13533,0,0,0,1,0,1
13534,0,0,0,1,0,1
13535,0,1,0,0,0,1
13536,0,0,0,1,0,1
13537,0,1,0,0,0,1
13538,0,0,0,1,0,1
13539,1,0,0,0,0,1
13540,0,1,0,0,0,1
13541,1,0,0,0,0,1
13542,0,1,0,0,0,1
13543,0,1,0,0,0,1
13544,0,0,0,1,0,1
13545,1,0,0,0,0,1
13546,0,1,0,0,0,1
13547,0,1,0,0,0,1
13548,0,0,0,1,0,1
13549,0,1,0,0,0,1
13550,0,1,0,0,0,1
13551,0,1,0,0,0,1
13552,1,0,0,0,0,1
13553,1,0,0,0,0,1
13554,1,0,0,0,0,1
13555,1,0,0,0,0,1
13556,1,0,0,0,0,1
13557,0,1,0,0,0,1
13558,0,1,0,0,0,1
13559,1,0,0,0,0,1
13560,0,0,0,1,0,1
13561,0,1,0,0,0,1
13562,0,1,0,0,0,1
13563,0,1,0,0,0,1
13564,0,0,0,1,0,1
13565,0,0,0,1,0,1
13566,0,0,0,1,0,1
13567,0,0,0,1,0,1
13568,0,1,0,0,0,1
13569,0,1,0,0,0,1
13570,0,0,0,1,0,1
13571,0,0,0,1,0,1
13572,0,0,0,0,1,1
13573,0,1,0,0,0,1
13574,0,0,0,0,1,1
13575,1,0,0,0,0,1
13576,1,0,0,0,0,1
13577,1,0,0,0,0,1
13578,1,0,0,0,0,1
13579,1,0,0,0,0,1
13580,0,1,0,0,0,1
13581,1,0,0,0,0,1
13582,0,0,0,0,1,1
13583,1,0,0,0,0,1
13584,1,0,0,0,0,1
13585,1,0,0,0,0,1
13586,1,0,0,0,0,1
13587,1,0,0,0,0,1
13588,1,0,0,0,0,1
13589,1,0,0,0,0,1
13590,1,0,0,0,0,1
13591,0,0,0,0,1,1
13592,0,0,0,0,1,1
13593,1,0,0,0,0,1
13594,1,0,0,0,0,1
13595,1,0,0,0,0,1
13596,0,0,0,0,1,1
13597,1,0,0,0,0,1
13598,1,0,0,0,0,1
13599,1,0,0,0,0,1
13600,0,1,0,0,0,1
13601,1,0,0,0,0,1
13602,1,0,0,0,0,1
13603,1,0,0,0,0,1
13604,1,0,0,0,0,1
13605,1,0,0,0,0,1
13606,1,0,0,0,0,1
13607,0,0,0,0,1,1
13608,1,0,0,0,0,1
13609,1,0,0,0,0,1
13610,0,0,0,0,1,1
13611,1,0,0,0,0,1
13612,0,0,0,0,1,1
13613,1,0,0,0,0,1
13614,1,0,0,0,0,1
13615,0,1,0,0,0,1
13616,0,1,0,0,0,1
13617,0,0,0,0,1,1
13618,0,0,0,0,1,1
13619,0,0,0,0,1,1
13620,0,1,0,0,0,1
13621,1,0,0,0,0,1
13622,1,0,0,0,0,1
13623,1,0,0,0,0,1
13624,1,0,0,0,0,1
13625,1,0,0,0,0,1
13626,1,0,0,0,0,1
13627,1,0,0,0,0,1
13628,0,1,0,0,0,1
13629,0,0,0,0,1,1
13630,1,0,0,0,0,1
13631,1,0,0,0,0,1
13632,1,0,0,0,0,1
13633,0,1,0,0,0,1
13634,1,0,0,0,0,1
13635,1,0,0,0,0,1
13636,0,1,0,0,0,1
13637,0,1,0,0,0,1
13638,0,1,0,0,0,1
13639,0,1,0,0,0,1
13640,0,0,0,0,1,1
13641,0,1,0,0,0,1
13642,0,1,0,0,0,1
13643,0,1,0,0,0,1
13644,0,1,0,0,0,1
13645,1,0,0,0,0,1
13646,1,0,0,0,0,1
13647,0,1,0,0,0,1
13648,0,1,0,0,0,1
13649,0,0,0,0,1,1
13650,0,1,0,0,0,1
13651,0,1,0,0,0,1
13652,0,1,0,0,0,1
13653,0,1,0,0,0,1
13654,0,1,0,0,0,1
13655,0,1,0,0,0,1
13656,0,1,0,0,0,1
13657,0,1,0,0,0,1
13658,1,0,0,0,0,1
13659,0,1,0,0,0,1
13660,1,0,0,0,0,1
13661,0,1,0,0,0,1
13662,0,1,0,0,0,1
13663,1,0,0,0,0,1
13664,0,0,0,0,1,1
13665,0,0,0,0,1,1
13666,1,0,0,0,0,1
13667,0,1,0,0,0,1
13668,0,1,0,0,0,1
13669,0,1,0,0,0,1
13670,0,0,0,0,1,1
13671,0,1,0,0,0,1
13672,1,0,0,0,0,1
13673,0,1,0,0,0,1
13674,1,0,0,0,0,1
13675,0,1,0,0,0,1
13676,0,1,0,0,0,1
13677,1,0,0,0,0,1
13678,1,0,0,0,0,1
13679,0,1,0,0,0,1
13680,0,1,0,0,0,1
13681,0,1,0,0,0,1
13682,0,1,0,0,0,1
13683,0,1,0,0,0,1
13684,0,1,0,0,0,1
13685,0,0,0,0,1,1
13686,0,0,0,0,1,1
13687,1,0,0,0,0,1
13688,1,0,0,0,0,1
13689,1,0,0,0,0,1
13690,1,0,0,0,0,1
13691,1,0,0,0,0,1
13692,0,1,0,0,0,1
13693,1,0,0,0,0,1
13694,1,0,0,0,0,1
13695,1,0,0,0,0,1
13696,0,1,0,0,0,1
13697,0,0,0,0,1,1
13698,0,0,0,0,1,1
13699,0,0,0,0,1,1
13700,0,0,0,0,1,1
13701,0,1,0,0,0,1
13702,0,1,0,0,0,1
13703,0,1,0,0,0,1
13704,0,1,0,0,0,1
13705,0,1,0,0,0,1
13706,0,1,0,0,0,1
13707,0,1,0,0,0,1
13708,1,0,0,0,0,1
13709,0,1,0,0,0,1
13710,0,1,0,0,0,1
13711,1,0,0,0,0,1
13712,0,1,0,0,0,1
13713,0,0,0,0,1,1
13714,1,0,0,0,0,1
13715,1,0,0,0,0,1
13716,1,0,0,0,0,1
13717,0,1,0,0,0,1
13718,0,0,0,0,1,1
13719,0,0,0,0,1,1
13720,0,0,0,0,1,1
13721,0,1,0,0,0,1
13722,1,0,0,0,0,1
13723,0,0,0,0,1,1
13724,0,0,0,0,1,1
13725,0,0,0,0,1,1
13726,0,0,0,0,1,1
13727,0,0,0,0,1,1
13728,1,0,0,0,0,1
13729,0,0,0,0,1,1
13730,1,0,0,0,0,1
13731,1,0,0,0,0,1
13732,1,0,0,0,0,1
13733,1,0,0,0,0,1
13734,1,0,0,0,0,1
13735,1,0,0,0,0,1
13736,1,0,0,0,0,1
13737,1,0,0,0,0,1
13738,1,0,0,0,0,1
13739,1,0,0,0,0,1
13740,1,0,0,0,0,1
13741,0,0,0,0,1,1
13742,0,0,0,0,1,1
13743,0,0,0,0,1,1
13744,0,0,0,0,1,1
13745,1,0,0,0,0,1
13746,1,0,0,0,0,1
13747,0,0,0,0,1,1
13748,0,1,0,0,0,1
13749,1,0,0,0,0,1
13750,0,1,0,0,0,1
13751,1,0,0,0,0,1
13752,1,0,0,0,0,1
13753,0,0,0,0,1,1
13754,0,0,0,0,1,1
13755,1,0,0,0,0,1
13756,0,1,0,0,0,1
13757,0,1,0,0,0,1
13758,0,1,0,0,0,1
13759,0,1,0,0,0,1
13760,0,0,1,0,0,1
13761,0,1,0,0,0,1
13762,0,1,0,0,0,1
13763,0,0,1,0,0,1
13764,0,1,0,0,0,1
13765,0,0,1,0,0,1
13766,0,1,0,0,0,1
13767,0,1,0,0,0,1
13768,0,1,0,0,0,1
13769,0,1,0,0,0,1
13770,0,1,0,0,0,1
13771,0,1,0,0,0,1
13772,0,1,0,0,0,1
13773,0,1,0,0,0,1
13774,0,1,0,0,0,1
13775,0,1,0,0,0,1
13776,0,1,0,0,0,1
13777,1,0,0,0,0,1
13778,1,0,0,0,0,1
13779,1,0,0,0,0,1
13780,1,0,0,0,0,1
13781,0,1,0,0,0,1
13782,0,1,0,0,0,1
13783,0,0,0,0,1,1
13784,0,0,0,0,1,1
13785,0,0,0,0,1,1
13786,1,0,0,0,0,1
13787,0,1,0,0,0,1
13788,0,1,0,0,0,1
13789,0,1,0,0,0,1
13790,1,0,0,0,0,1
13791,1,0,0,0,0,1
13792,0,1,0,0,0,1
13793,0,1,0,0,0,1
13794,1,0,0,0,0,1
13795,0,1,0,0,0,1
13796,0,0,0,0,1,1
13797,1,0,0,0,0,1
13798,0,1,0,0,0,1
13799,0,1,0,0,0,1
13800,0,1,0,0,0,1
13801,1,0,0,0,0,1
13802,1,0,0,0,0,1
13803,0,1,0,0,0,1
13804,1,0,0,0,0,1
13805,0,1,0,0,0,1
13806,0,1,0,0,0,1
13807,1,0,0,0,0,1
13808,1,0,0,0,0,1
13809,0,1,0,0,0,1
13810,0,1,0,0,0,1
13811,1,0,0,0,0,1
13812,0,1,0,0,0,1
13813,1,0,0,0,0,1
13814,1,0,0,0,0,1
13815,1,0,0,0,0,1
13816,1,0,0,0,0,1
13817,0,1,0,0,0,1
13818,0,1,0,0,0,1
13819,1,0,0,0,0,1
13820,0,1,0,0,0,1
13821,1,0,0,0,0,1
13822,0,1,0,0,0,1
13823,0,1,0,0,0,1
13824,0,1,0,0,0,1
13825,0,0,0,0,1,1
13826,0,0,0,0,1,1
13827,0,0,0,0,1,1
13828,1,0,0,0,0,1
13829,0,1,0,0,0,1
13830,0,1,0,0,0,1
13831,0,0,0,0,1,1
13832,0,1,0,0,0,1
13833,0,1,0,0,0,1
13834,0,1,0,0,0,1
13835,0,1,0,0,0,1
13836,0,1,0,0,0,1
13837,1,0,0,0,0,1
13838,1,0,0,0,0,1
13839,0,1,0,0,0,1
13840,0,1,0,0,0,1
13841,0,1,0,0,0,1
13842,0,1,0,0,0,1
13843,0,1,0,0,0,1
13844,1,0,0,0,0,1
13845,0,1,0,0,0,1
13846,0,1,0,0,0,1
13847,0,0,1,0,0,1
13848,0,1,0,0,0,1
13849,0,1,0,0,0,1
13850,0,0,1,0,0,1
13851,0,1,0,0,0,1
13852,0,1,0,0,0,1
13853,0,1,0,0,0,1
13854,0,1,0,0,0,1
13855,0,1,0,0,0,1
13856,0,1,0,0,0,1
13857,0,1,0,0,0,1
13858,1,0,0,0,0,1
13859,1,0,0,0,0,1
13860,1,0,0,0,0,1
13861,1,0,0,0,0,1
13862,1,0,0,0,0,1
13863,1,0,0,0,0,1
13864,0,0,1,0,0,1
13865,0,1,0,0,0,1
13866,0,0,1,0,0,1
13867,1,0,0,0,0,1
13868,1,0,0,0,0,1
13869,1,0,0,0,0,1
13870,1,0,0,0,0,1
13871,1,0,0,0,0,1
13872,1,0,0,0,0,1
13873,0,1,0,0,0,1
13874,0,0,0,0,1,1
13875,1,0,0,0,0,1
13876,0,1,0,0,0,1
13877,0,1,0,0,0,1
13878,0,0,0,0,1,1
13879,1,0,0,0,0,1
13880,0,1,0,0,0,1
13881,0,1,0,0,0,1
13882,0,1,0,0,0,1
13883,0,1,0,0,0,1
13884,0,1,0,0,0,1
13885,1,0,0,0,0,1
13886,1,0,0,0,0,1
13887,1,0,0,0,0,1
13888,1,0,0,0,0,1
13889,1,0,0,0,0,1
13890,0,1,0,0,0,1
13891,0,1,0,0,0,1
13892,1,0,0,0,0,1
13893,1,0,0,0,0,1
13894,0,1,0,0,0,1
13895,0,0,0,0,1,1
13896,1,0,0,0,0,1
13897,1,0,0,0,0,1
13898,1,0,0,0,0,1
13899,0,1,0,0,0,1
13900,1,0,0,0,0,1
13901,1,0,0,0,0,1
13902,0,1,0,0,0,1
13903,0,1,0,0,0,1
13904,0,1,0,0,0,1
13905,0,1,0,0,0,1
13906,0,0,1,0,0,1
13907,0,1,0,0,0,1
13908,0,0,1,0,0,1
13909,0,1,0,0,0,1
13910,0,1,0,0,0,1
13911,0,1,0,0,0,1
13912,0,1,0,0,0,1
13913,0,1,0,0,0,1
13914,0,0,1,0,0,1
13915,0,1,0,0,0,1
13916,0,0,1,0,0,1
13917,1,0,0,0,0,1
13918,1,0,0,0,0,1
13919,0,1,0,0,0,1
13920,0,1,0,0,0,1
13921,0,1,0,0,0,1
13922,1,0,0,0,0,1
13923,1,0,0,0,0,1
13924,0,1,0,0,0,1
13925,1,0,0,0,0,1
13926,0,1,0,0,0,1
13927,0,1,0,0,0,1
13928,0,1,0,0,0,1
13929,0,1,0,0,0,1
13930,0,0,1,0,0,1
13931,0,0,1,0,0,1
13932,1,0,0,0,0,1
13933,1,0,0,0,0,1
13934,1,0,0,0,0,1
13935,1,0,0,0,0,1
13936,0,0,0,0,1,1
13937,1,0,0,0,0,1
13938,1,0,0,0,0,1
13939,1,0,0,0,0,1
13940,1,0,0,0,0,1
13941,1,0,0,0,0,1
13942,0,0,0,0,1,1
13943,1,0,0,0,0,1
13944,1,0,0,0,0,1
13945,0,1,0,0,0,1
13946,0,1,0,0,0,1
13947,1,0,0,0,0,1
13948,1,0,0,0,0,1
13949,1,0,0,0,0,1
13950,0,1,0,0,0,1
13951,0,1,0,0,0,1
13952,1,0,0,0,0,1
13953,1,0,0,0,0,1
13954,0,1,0,0,0,1
13955,0,1,0,0,0,1
13956,0,1,0,0,0,1
13957,0,1,0,0,0,1
13958,1,0,0,0,0,1
13959,1,0,0,0,0,1
13960,0,1,0,0,0,1
13961,0,1,0,0,0,1
13962,0,0,0,0,1,1
13963,1,0,0,0,0,1
13964,1,0,0,0,0,1
13965,0,1,0,0,0,1
13966,1,0,0,0,0,1
13967,1,0,0,0,0,1
13968,1,0,0,0,0,1
13969,0,1,0,0,0,1
13970,1,0,0,0,0,1
13971,1,0,0,0,0,1
13972,0,0,0,0,1,1
13973,0,1,0,0,0,1
13974,1,0,0,0,0,1
13975,1,0,0,0,0,1
13976,1,0,0,0,0,1
13977,0,1,0,0,0,1
13978,0,0,0,0,1,1
13979,0,1,0,0,0,1
13980,0,0,0,0,1,1
13981,1,0,0,0,0,1
13982,1,0,0,0,0,1
13983,1,0,0,0,0,1
13984,0,1,0,0,0,1
13985,0,1,0,0,0,1
13986,0,1,0,0,0,1
13987,0,1,0,0,0,1
13988,1,0,0,0,0,1
13989,1,0,0,0,0,1
13990,1,0,0,0,0,1
13991,0,0,1,0,0,1
13992,0,0,1,0,0,1
13993,1,0,0,0,0,1
13994,0,0,1,0,0,1
13995,0,0,1,0,0,1
13996,1,0,0,0,0,1
13997,0,0,0,0,1,1
13998,0,0,1,0,0,1
13999,1,0,0,0,0,1
14000,1,0,0,0,0,1
14001,1,0,0,0,0,1
14002,0,1,0,0,0,1
14003,0,1,0,0,0,1
14004,0,0,1,0,0,1
14005,1,0,0,0,0,1
14006,0,0,1,0,0,1
14007,0,1,0,0,0,1
14008,0,1,0,0,0,1
14009,0,1,0,0,0,1
14010,1,0,0,0,0,1
14011,0,1,0,0,0,1
14012,0,1,0,0,0,1
14013,1,0,0,0,0,1
14014,0,1,0,0,0,1
14015,0,1,0,0,0,1
14016,0,1,0,0,0,1
14017,0,1,0,0,0,1
14018,0,0,0,0,1,1
14019,0,1,0,0,0,1
14020,1,0,0,0,0,1
14021,1,0,0,0,0,1
14022,0,1,0,0,0,1
14023,1,0,0,0,0,1
14024,0,1,0,0,0,1
14025,0,1,0,0,0,1
14026,0,0,0,0,1,1
14027,0,1,0,0,0,1
14028,0,1,0,0,0,1
14029,0,0,0,0,1,1
14030,0,1,0,0,0,1
14031,0,1,0,0,0,1
14032,0,1,0,0,0,1
14033,0,1,0,0,0,1
14034,0,1,0,0,0,1
14035,0,1,0,0,0,1
14036,0,1,0,0,0,1
14037,0,0,1,0,0,1
14038,0,0,1,0,0,1
14039,1,0,0,0,0,1
14040,1,0,0,0,0,1
14041,0,0,1,0,0,1
14042,0,0,1,0,0,1
14043,1,0,0,0,0,1
14044,0,0,0,0,1,1
14045,0,0,0,0,1,1
14046,1,0,0,0,0,1
14047,0,1,0,0,0,1
14048,0,0,0,0,1,1
14049,0,0,0,0,1,1
14050,1,0,0,0,0,1
14051,1,0,0,0,0,1
14052,1,0,0,0,0,1
14053,0,0,0,0,1,1
14054,0,0,0,0,1,1
14055,1,0,0,0,0,1
14056,1,0,0,0,0,1
14057,1,0,0,0,0,1
14058,0,0,0,0,1,1
14059,0,0,1,0,0,1
14060,0,1,0,0,0,1
14061,1,0,0,0,0,1
14062,0,1,0,0,0,1
14063,1,0,0,0,0,1
14064,1,0,0,0,0,1
14065,0,0,0,0,1,1
14066,1,0,0,0,0,1
14067,0,0,0,0,1,1
14068,0,1,0,0,0,1
14069,1,0,0,0,0,1
14070,0,1,0,0,0,1
14071,0,0,0,0,1,1
14072,1,0,0,0,0,1
14073,0,1,0,0,0,1
14074,0,0,0,0,1,1
14075,0,0,0,1,0,1
14076,0,0,0,1,0,1
14077,0,1,0,0,0,1
14078,0,1,0,0,0,1
14079,0,0,0,1,0,1
14080,0,1,0,0,0,1
14081,1,0,0,0,0,1
14082,0,0,1,0,0,1
14083,0,1,0,0,0,1
14084,1,0,0,0,0,1
14085,0,1,0,0,0,1
14086,0,0,1,0,0,1
14087,0,0,0,0,1,1
14088,0,0,0,0,1,1
14089,1,0,0,0,0,1
14090,0,0,0,0,1,1
14091,1,0,0,0,0,1
14092,1,0,0,0,0,1
14093,1,0,0,0,0,1
14094,0,0,0,0,1,1
14095,0,0,1,0,0,1
14096,1,0,0,0,0,1
14097,0,1,0,0,0,1
14098,1,0,0,0,0,1
14099,0,1,0,0,0,1
14100,1,0,0,0,0,1
14101,1,0,0,0,0,1
14102,0,0,1,0,0,1
14103,0,0,1,0,0,1
14104,1,0,0,0,0,1
14105,0,1,0,0,0,1
14106,0,0,1,0,0,1
14107,0,1,0,0,0,1
14108,0,0,1,0,0,1
14109,0,0,1,0,0,1
14110,0,0,0,0,1,1
14111,0,1,0,0,0,1
14112,0,1,0,0,0,1
14113,1,0,0,0,0,1
14114,1,0,0,0,0,1
14115,0,0,1,0,0,1
14116,0,1,0,0,0,1
14117,1,0,0,0,0,1
14118,0,1,0,0,0,1
14119,0,1,0,0,0,1
14120,1,0,0,0,0,1
14121,1,0,0,0,0,1
14122,0,1,0,0,0,1
14123,0,1,0,0,0,1
14124,0,1,0,0,0,1
14125,0,1,0,0,0,1
14126,0,1,0,0,0,1
14127,0,1,0,0,0,1
14128,0,1,0,0,0,1
14129,1,0,0,0,0,1
14130,0,1,0,0,0,1
14131,0,0,0,0,1,1
14132,1,0,0,0,0,1
14133,1,0,0,0,0,1
14134,1,0,0,0,0,1
14135,1,0,0,0,0,1
14136,1,0,0,0,0,1
14137,0,0,0,0,1,1
14138,1,0,0,0,0,1
14139,0,0,0,0,1,1
14140,0,0,0,0,1,1
14141,0,1,0,0,0,1
14142,0,1,0,0,0,1
14143,1,0,0,0,0,1
14144,1,0,0,0,0,1
14145,0,0,1,0,0,1
14146,1,0,0,0,0,1
14147,1,0,0,0,0,1
14148,0,1,0,0,0,1
14149,0,1,0,0,0,1
14150,1,0,0,0,0,1
14151,0,1,0,0,0,1
14152,0,0,0,1,0,1
14153,0,1,0,0,0,1
14154,0,1,0,0,0,1
14155,0,1,0,0,0,1
14156,0,0,0,1,0,1
14157,0,1,0,0,0,1
14158,0,0,0,1,0,1
14159,0,1,0,0,0,1
14160,0,1,0,0,0,1
14161,0,0,0,0,1,1
14162,1,0,0,0,0,1
14163,1,0,0,0,0,1
14164,0,1,0,0,0,1
14165,0,0,0,1,0,1
14166,0,0,0,1,0,1
14167,0,0,0,1,0,1
14168,0,0,0,1,0,1
14169,0,0,0,1,0,1
14170,0,0,0,1,0,1
14171,0,1,0,0,0,1
14172,0,0,0,1,0,1
14173,0,0,0,1,0,1
14174,0,0,0,1,0,1
14175,0,1,0,0,0,1
14176,0,1,0,0,0,1
14177,0,1,0,0,0,1
14178,0,1,0,0,0,1
14179,0,1,0,0,0,1
14180,0,0,1,0,0,1
14181,0,1,0,0,0,1
14182,0,1,0,0,0,1
14183,0,0,0,0,1,1
14184,0,1,0,0,0,1
14185,0,1,0,0,0,1
14186,0,0,1,0,0,1
14187,0,0,1,0,0,1
14188,1,0,0,0,0,1
14189,0,0,0,0,1,1
14190,1,0,0,0,0,1
14191,1,0,0,0,0,1
14192,1,0,0,0,0,1
14193,0,1,0,0,0,1
14194,0,1,0,0,0,1
14195,0,1,0,0,0,1
14196,1,0,0,0,0,1
14197,1,0,0,0,0,1
14198,0,0,0,0,1,1
14199,0,1,0,0,0,1
14200,0,1,0,0,0,1
14201,1,0,0,0,0,1
14202,0,1,0,0,0,1
14203,1,0,0,0,0,1
14204,0,0,1,0,0,1
14205,0,1,0,0,0,1
14206,0,1,0,0,0,1
14207,0,0,1,0,0,1
14208,0,0,1,0,0,1
14209,1,0,0,0,0,1
14210,0,0,0,0,1,1
14211,1,0,0,0,0,1
14212,0,0,0,0,1,1
14213,1,0,0,0,0,1
14214,1,0,0,0,0,1
14215,0,1,0,0,0,1
14216,1,0,0,0,0,1
14217,1,0,0,0,0,1
14218,0,0,1,0,0,1
14219,1,0,0,0,0,1
14220,1,0,0,0,0,1
14221,1,0,0,0,0,1
14222,1,0,0,0,0,1
14223,0,1,0,0,0,1
14224,1,0,0,0,0,1
14225,0,0,0,0,1,1
14226,0,1,0,0,0,1
14227,1,0,0,0,0,1
14228,0,0,1,0,0,1
14229,0,0,0,0,1,1
14230,0,1,0,0,0,1
14231,1,0,0,0,0,1
14232,0,0,0,0,1,1
14233,0,0,0,1,0,1
14234,0,1,0,0,0,1
14235,0,1,0,0,0,1
14236,0,1,0,0,0,1
14237,0,1,0,0,0,1
14238,0,1,0,0,0,1
14239,1,0,0,0,0,1
14240,1,0,0,0,0,1
14241,1,0,0,0,0,1
14242,1,0,0,0,0,1
14243,0,1,0,0,0,1
14244,1,0,0,0,0,1
14245,0,1,0,0,0,1
14246,1,0,0,0,0,1
14247,0,0,0,1,0,1
14248,0,0,0,1,0,1
14249,0,0,0,1,0,1
14250,0,0,0,1,0,1
14251,0,0,0,1,0,1
14252,0,0,0,1,0,1
14253,0,0,0,1,0,1
14254,0,0,0,1,0,1
14255,0,0,0,1,0,1
14256,0,0,0,1,0,1
14257,0,0,0,1,0,1
14258,1,0,0,0,0,1
14259,0,0,0,1,0,1
14260,0,0,0,1,0,1
14261,0,0,0,1,0,1
14262,0,0,0,1,0,1
14263,1,0,0,0,0,1
14264,0,1,0,0,0,1
14265,0,1,0,0,0,1
14266,0,1,0,0,0,1
14267,0,1,0,0,0,1
14268,1,0,0,0,0,1
14269,0,1,0,0,0,1
14270,0,0,0,1,0,1
14271,0,0,0,1,0,1
14272,1,0,0,0,0,1
14273,1,0,0,0,0,1
14274,0,0,0,0,1,1
14275,0,0,0,0,1,1
14276,0,0,0,0,1,1
14277,0,0,1,0,0,1
14278,1,0,0,0,0,1
14279,0,0,0,0,1,1
14280,1,0,0,0,0,1
14281,0,0,1,0,0,1
14282,0,0,0,0,1,1
14283,1,0,0,0,0,1
14284,0,1,0,0,0,1
14285,1,0,0,0,0,1
14286,0,0,0,0,1,1
14287,0,0,0,0,1,1
14288,0,0,0,0,1,1
14289,0,1,0,0,0,1
14290,1,0,0,0,0,1
14291,0,0,1,0,0,1
14292,1,0,0,0,0,1
14293,0,0,1,0,0,1
14294,0,1,0,0,0,1
14295,0,0,0,0,1,1
14296,0,0,1,0,0,1
14297,0,1,0,0,0,1
14298,1,0,0,0,0,1
14299,0,1,0,0,0,1
14300,1,0,0,0,0,1
14301,0,1,0,0,0,1
14302,0,1,0,0,0,1
14303,0,0,0,0,1,1
14304,0,0,0,0,1,1
14305,0,0,0,0,1,1
14306,0,0,0,0,1,1
14307,0,0,0,0,1,1
14308,0,0,0,0,1,1
14309,0,0,0,0,1,1
14310,0,0,0,0,1,1
14311,0,1,0,0,0,1
14312,0,0,0,0,1,1
14313,0,1,0,0,0,1
14314,0,0,1,0,0,1
14315,0,1,0,0,0,1
14316,0,0,0,0,1,1
14317,0,1,0,0,0,1
14318,1,0,0,0,0,1
14319,1,0,0,0,0,1
14320,0,0,0,0,1,1
14321,0,0,1,0,0,1
14322,1,0,0,0,0,1
14323,1,0,0,0,0,1
14324,0,0,1,0,0,1
14325,0,0,0,0,1,1
14326,0,0,0,0,1,1
14327,0,1,0,0,0,1
14328,0,0,1,0,0,1
14329,1,0,0,0,0,1
14330,0,0,0,1,0,1
14331,0,0,0,1,0,1
14332,0,1,0,0,0,1
14333,0,0,0,1,0,1
14334,0,0,0,1,0,1
14335,0,0,0,1,0,1
14336,0,0,0,1,0,1
14337,0,1,0,0,0,1
14338,1,0,0,0,0,1
14339,1,0,0,0,0,1
14340,0,0,1,0,0,1
14341,0,0,1,0,0,1
14342,0,0,0,0,1,1
14343,0,0,1,0,0,1
14344,0,0,1,0,0,1
14345,0,0,0,0,1,1
14346,0,0,0,0,1,1
14347,0,0,0,0,1,1
14348,0,0,0,0,1,1
14349,0,0,0,0,1,1
14350,0,0,0,0,1,1
14351,0,0,0,1,0,1
14352,0,0,0,0,1,1
14353,0,0,0,1,0,1
14354,0,0,1,0,0,1
14355,0,0,1,0,0,1
14356,0,0,0,0,1,1
14357,0,0,0,0,1,1
14358,0,0,0,0,1,1
14359,1,0,0,0,0,1
14360,1,0,0,0,0,1
14361,0,0,0,0,1,1
14362,1,0,0,0,0,1
14363,1,0,0,0,0,1
14364,0,0,0,0,1,1
14365,0,1,0,0,0,1
14366,0,0,0,0,1,1
14367,0,0,0,0,1,1
14368,0,1,0,0,0,1
14369,0,0,0,0,1,1
14370,0,0,0,0,1,1
14371,0,0,0,0,1,1
14372,0,0,0,0,1,1
14373,0,0,0,0,1,1
14374,0,1,0,0,0,1
14375,0,0,0,0,1,1
14376,1,0,0,0,0,1
14377,0,1,0,0,0,1
14378,0,0,1,0,0,1
14379,0,0,1,0,0,1
14380,0,0,1,0,0,1
14381,0,0,0,0,1,1
14382,0,0,0,0,1,1
14383,0,1,0,0,0,1
14384,0,0,1,0,0,1
14385,0,0,1,0,0,1
14386,0,0,1,0,0,1
14387,0,0,1,0,0,1
14388,1,0,0,0,0,1
14389,0,0,1,0,0,1
14390,0,0,1,0,0,1
14391,1,0,0,0,0,1
14392,0,1,0,0,0,1
14393,0,1,0,0,0,1
14394,0,0,1,0,0,1
14395,0,0,1,0,0,1
14396,1,0,0,0,0,1
14397,0,0,1,0,0,1
14398,1,0,0,0,0,1
14399,1,0,0,0,0,1
14400,0,1,0,0,0,1
14401,0,1,0,0,0,1
14402,1,0,0,0,0,1
14403,1,0,0,0,0,1
14404,1,0,0,0,0,1
14405,0,1,0,0,0,1
14406,1,0,0,0,0,1
14407,1,0,0,0,0,1
14408,0,0,0,0,1,1
14409,1,0,0,0,0,1
14410,0,1,0,0,0,1
14411,0,1,0,0,0,1
14412,1,0,0,0,0,1
14413,0,0,0,0,1,1
14414,0,0,0,0,1,1
14415,0,0,0,0,1,1
14416,1,0,0,0,0,1
14417,0,0,0,0,1,1
14418,1,0,0,0,0,1
14419,0,1,0,0,0,1
14420,0,1,0,0,0,1
14421,0,0,0,1,0,1
14422,0,0,0,0,1,1
14423,0,0,0,0,1,1
14424,0,1,0,0,0,1
14425,0,1,0,0,0,1
14426,0,1,0,0,0,1
14427,0,1,0,0,0,1
14428,0,0,0,1,0,1
14429,0,0,0,0,1,1
14430,0,1,0,0,0,1
14431,0,0,0,0,1,1
14432,0,1,0,0,0,1
14433,0,1,0,0,0,1
14434,0,0,0,0,1,1
14435,0,1,0,0,0,1
14436,0,0,0,0,1,1
14437,0,0,0,0,1,1
14438,0,0,0,0,1,1
14439,0,0,0,0,1,1
14440,1,0,0,0,0,1
14441,1,0,0,0,0,1
14442,0,1,0,0,0,1
14443,0,1,0,0,0,1
14444,0,1,0,0,0,1
14445,0,1,0,0,0,1
14446,0,0,0,1,0,1
14447,0,0,0,1,0,1
14448,1,0,0,0,0,1
14449,0,0,0,1,0,1
14450,0,1,0,0,0,1
14451,1,0,0,0,0,1
14452,1,0,0,0,0,1
14453,0,1,0,0,0,1
14454,1,0,0,0,0,1
14455,1,0,0,0,0,1
14456,1,0,0,0,0,1
14457,0,1,0,0,0,1
14458,0,0,0,0,1,1
14459,0,1,0,0,0,1
14460,1,0,0,0,0,1
14461,0,0,0,1,0,1
14462,0,1,0,0,0,1
14463,0,0,0,0,1,1
14464,0,1,0,0,0,1
14465,1,0,0,0,0,1
14466,0,1,0,0,0,1
14467,0,1,0,0,0,1
14468,1,0,0,0,0,1
14469,0,1,0,0,0,1
14470,0,1,0,0,0,1
14471,0,1,0,0,0,1
14472,0,0,0,1,0,1
14473,1,0,0,0,0,1
14474,0,1,0,0,0,1
14475,1,0,0,0,0,1
14476,0,1,0,0,0,1
14477,0,0,0,0,1,1
14478,0,0,0,0,1,1
14479,0,0,0,0,1,1
14480,0,0,0,0,1,1
14481,0,1,0,0,0,1
14482,0,0,0,0,1,1
14483,0,0,0,0,1,1
14484,0,0,0,0,1,1
14485,0,0,0,0,1,1
14486,1,0,0,0,0,1
14487,1,0,0,0,0,1
14488,0,1,0,0,0,1
14489,0,0,0,0,1,1
14490,1,0,0,0,0,1
14491,1,0,0,0,0,1
14492,0,0,0,0,1,1
14493,0,1,0,0,0,1
14494,1,0,0,0,0,1
14495,0,1,0,0,0,1
14496,0,0,0,0,1,1
14497,1,0,0,0,0,1
14498,0,0,0,0,1,1
14499,0,1,0,0,0,1
14500,0,0,0,0,1,1
14501,0,0,0,0,1,1
14502,0,0,0,0,1,1
14503,0,0,0,0,1,1
14504,0,1,0,0,0,1
14505,0,0,0,0,1,1
14506,0,1,0,0,0,1
14507,0,0,0,0,1,1
14508,0,1,0,0,0,1
14509,0,0,0,0,1,1
14510,0,0,0,0,1,1
14511,0,0,0,0,1,1
14512,0,0,0,1,0,1
14513,0,0,0,1,0,1
14514,0,1,0,0,0,1
14515,1,0,0,0,0,1
14516,1,0,0,0,0,1
14517,0,1,0,0,0,1
14518,1,0,0,0,0,1
14519,0,0,0,1,0,1
14520,1,0,0,0,0,1
14521,0,1,0,0,0,1
14522,0,1,0,0,0,1
14523,0,0,0,1,0,1
14524,0,0,0,1,0,1
14525,1,0,0,0,0,1
14526,0,1,0,0,0,1
14527,1,0,0,0,0,1
14528,0,1,0,0,0,1
14529,1,0,0,0,0,1
14530,1,0,0,0,0,1
14531,0,1,0,0,0,1
14532,0,0,0,1,0,1
14533,0,0,0,1,0,1
14534,0,1,0,0,0,1
14535,0,1,0,0,0,1
14536,0,1,0,0,0,1
14537,0,1,0,0,0,1
14538,0,0,0,0,1,1
14539,0,0,0,1,0,1
14540,1,0,0,0,0,1
14541,0,1,0,0,0,1
14542,0,1,0,0,0,1
14543,0,1,0,0,0,1
14544,1,0,0,0,0,1
14545,1,0,0,0,0,1
14546,0,0,0,0,1,1
14547,0,1,0,0,0,1
14548,1,0,0,0,0,1
14549,0,0,0,0,1,1
14550,1,0,0,0,0,1
14551,0,0,0,0,1,1
14552,0,0,0,0,1,1
14553,1,0,0,0,0,1
14554,1,0,0,0,0,1
14555,0,0,0,0,1,1
14556,0,1,0,0,0,1
14557,1,0,0,0,0,1
14558,0,1,0,0,0,1
14559,1,0,0,0,0,1
14560,1,0,0,0,0,1
14561,1,0,0,0,0,1
14562,0,1,0,0,0,1
14563,0,1,0,0,0,1
14564,1,0,0,0,0,1
14565,1,0,0,0,0,1
14566,1,0,0,0,0,1
14567,1,0,0,0,0,1
14568,0,0,0,0,1,1
14569,1,0,0,0,0,1
14570,1,0,0,0,0,1
14571,1,0,0,0,0,1
14572,1,0,0,0,0,1
14573,1,0,0,0,0,1
14574,0,0,0,0,1,1
14575,0,0,0,0,1,1
14576,0,1,0,0,0,1
14577,0,0,0,1,0,1
14578,0,1,0,0,0,1
14579,1,0,0,0,0,1
14580,0,1,0,0,0,1
14581,0,1,0,0,0,1
14582,1,0,0,0,0,1
14583,1,0,0,0,0,1
14584,0,1,0,0,0,1
14585,0,0,0,1,0,1
14586,1,0,0,0,0,1
14587,1,0,0,0,0,1
14588,0,0,0,1,0,1
14589,0,1,0,0,0,1
14590,0,1,0,0,0,1
14591,0,0,0,1,0,1
14592,1,0,0,0,0,1
14593,0,1,0,0,0,1
14594,1,0,0,0,0,1
14595,0,1,0,0,0,1
14596,0,1,0,0,0,1
14597,0,0,1,0,0,1
14598,1,0,0,0,0,1
14599,0,1,0,0,0,1
14600,1,0,0,0,0,1
14601,0,0,0,1,0,1
14602,0,0,0,1,0,1
14603,1,0,0,0,0,1
14604,1,0,0,0,0,1
14605,1,0,0,0,0,1
14606,0,0,0,0,1,1
14607,0,0,0,0,1,1
14608,1,0,0,0,0,1
14609,1,0,0,0,0,1
14610,0,0,0,0,1,1
14611,0,0,0,0,1,1
14612,1,0,0,0,0,1
14613,1,0,0,0,0,1
14614,0,1,0,0,0,1
14615,0,0,0,0,1,1
14616,0,0,0,0,1,1
14617,1,0,0,0,0,1
14618,1,0,0,0,0,1
14619,0,0,0,0,1,1
14620,0,0,0,0,1,1
14621,0,0,0,0,1,1
14622,0,0,0,0,1,1
14623,0,0,0,0,1,1
14624,0,0,0,0,1,1
14625,0,0,0,0,1,1
14626,0,0,0,0,1,1
14627,0,1,0,0,0,1
14628,0,1,0,0,0,1
14629,0,1,0,0,0,1
14630,1,0,0,0,0,1
14631,0,1,0,0,0,1
14632,0,1,0,0,0,1
14633,0,1,0,0,0,1
14634,0,1,0,0,0,1
14635,0,0,1,0,0,1
14636,0,1,0,0,0,1
14637,0,1,0,0,0,1
14638,1,0,0,0,0,1
14639,0,1,0,0,0,1
14640,0,1,0,0,0,1
14641,0,0,1,0,0,1
14642,0,1,0,0,0,1
14643,1,0,0,0,0,1
14644,0,0,1,0,0,1
14645,1,0,0,0,0,1
14646,1,0,0,0,0,1
14647,0,0,0,0,1,1
14648,0,0,0,0,1,1
14649,0,0,0,0,1,1
14650,1,0,0,0,0,1
14651,0,1,0,0,0,1
14652,1,0,0,0,0,1
14653,1,0,0,0,0,1
14654,0,0,0,0,1,1
14655,0,1,0,0,0,1
14656,0,1,0,0,0,1
14657,1,0,0,0,0,1
14658,0,1,0,0,0,1
14659,0,1,0,0,0,1
14660,1,0,0,0,0,1
14661,0,1,0,0,0,1
14662,0,0,1,0,0,1
14663,0,0,1,0,0,1
14664,0,0,0,1,0,1
14665,0,0,0,1,0,1
14666,0,1,0,0,0,1
14667,0,0,0,1,0,1
14668,0,0,0,1,0,1
14669,1,0,0,0,0,1
14670,1,0,0,0,0,1
14671,0,1,0,0,0,1
14672,0,1,0,0,0,1
14673,0,1,0,0,0,1
14674,0,0,0,0,1,1
14675,1,0,0,0,0,1
14676,1,0,0,0,0,1
14677,1,0,0,0,0,1
14678,1,0,0,0,0,1
14679,1,0,0,0,0,1
14680,1,0,0,0,0,1
14681,1,0,0,0,0,1
14682,1,0,0,0,0,1
14683,1,0,0,0,0,1
14684,1,0,0,0,0,1
14685,1,0,0,0,0,1
14686,1,0,0,0,0,1
14687,1,0,0,0,0,1
14688,0,1,0,0,0,1
14689,1,0,0,0,0,1
14690,0,1,0,0,0,1
14691,0,1,0,0,0,1
14692,0,1,0,0,0,1
14693,0,1,0,0,0,1
14694,0,1,0,0,0,1
14695,1,0,0,0,0,1
14696,0,0,0,0,1,1
14697,0,1,0,0,0,1
14698,0,1,0,0,0,1
14699,0,1,0,0,0,1
14700,0,1,0,0,0,1
14701,0,0,0,0,1,1
14702,0,1,0,0,0,1
14703,0,1,0,0,0,1
14704,0,1,0,0,0,1
14705,0,1,0,0,0,1
14706,0,1,0,0,0,1
14707,0,1,0,0,0,1
14708,0,1,0,0,0,1
14709,1,0,0,0,0,1
14710,1,0,0,0,0,1
14711,0,0,1,0,0,1
14712,0,0,1,0,0,1
14713,1,0,0,0,0,1
14714,1,0,0,0,0,1
14715,1,0,0,0,0,1
14716,1,0,0,0,0,1
14717,1,0,0,0,0,1
14718,1,0,0,0,0,1
14719,1,0,0,0,0,1
14720,1,0,0,0,0,1
14721,1,0,0,0,0,1
14722,1,0,0,0,0,1
14723,0,0,0,0,1,1
14724,0,1,0,0,0,1
14725,0,1,0,0,0,1
14726,0,0,0,0,1,1
14727,0,1,0,0,0,1
14728,0,1,0,0,0,1
14729,0,1,0,0,0,1
14730,0,1,0,0,0,1
14731,0,1,0,0,0,1
14732,0,0,0,0,1,1
14733,0,0,0,0,1,1
14734,0,1,0,0,0,1
14735,0,1,0,0,0,1
14736,0,0,0,0,1,1
14737,0,0,0,0,1,1
14738,0,0,0,0,1,1
14739,0,1,0,0,0,1
14740,1,0,0,0,0,1
14741,0,0,0,0,1,1
14742,0,0,0,0,1,1
14743,0,0,0,0,1,1
14744,0,1,0,0,0,1
14745,0,1,0,0,0,1
14746,0,0,0,0,1,1
14747,0,1,0,0,0,1
14748,0,0,0,0,1,1
14749,0,1,0,0,0,1
14750,0,1,0,0,0,1
14751,0,1,0,0,0,1
14752,0,1,0,0,0,1
14753,1,0,0,0,0,1
14754,1,0,0,0,0,1
14755,1,0,0,0,0,1
14756,1,0,0,0,0,1
14757,1,0,0,0,0,1
14758,1,0,0,0,0,1
14759,0,0,0,0,1,1
14760,0,0,0,0,1,1
14761,1,0,0,0,0,1
14762,1,0,0,0,0,1
14763,1,0,0,0,0,1
14764,0,1,0,0,0,1
14765,0,1,0,0,0,1
14766,0,1,0,0,0,1
14767,0,1,0,0,0,1
14768,0,0,0,0,1,1
14769,0,0,0,0,1,1
14770,0,0,0,0,1,1
14771,0,1,0,0,0,1
14772,0,0,0,0,1,1
14773,0,1,0,0,0,1
14774,0,0,0,0,1,1
14775,0,1,0,0,0,1
14776,1,0,0,0,0,1
14777,0,0,0,0,1,1
14778,1,0,0,0,0,1
14779,1,0,0,0,0,1
14780,0,0,0,0,1,1
14781,0,1,0,0,0,1
14782,0,1,0,0,0,1
14783,0,1,0,0,0,1
14784,0,0,0,0,1,1
14785,0,1,0,0,0,1
14786,0,1,0,0,0,1
14787,0,0,1,0,0,1
14788,0,0,1,0,0,1
14789,0,0,0,1,0,1
14790,0,1,0,0,0,1
14791,0,0,1,0,0,1
14792,0,0,0,1,0,1
14793,0,1,0,0,0,1
14794,0,1,0,0,0,1
14795,0,1,0,0,0,1
14796,0,0,0,1,0,1
14797,0,0,0,1,0,1
14798,1,0,0,0,0,1
14799,1,0,0,0,0,1
14800,1,0,0,0,0,1
14801,0,0,1,0,0,1
14802,0,0,1,0,0,1
14803,1,0,0,0,0,1
14804,0,0,1,0,0,1
14805,0,0,1,0,0,1
14806,0,0,1,0,0,1
14807,0,0,1,0,0,1
14808,0,0,0,1,0,1
14809,0,0,1,0,0,1
14810,1,0,0,0,0,1
14811,0,0,0,0,1,1
14812,0,1,0,0,0,1
14813,0,1,0,0,0,1
14814,0,0,0,0,1,1
14815,0,0,0,0,1,1
14816,0,1,0,0,0,1
14817,0,0,0,0,1,1
14818,1,0,0,0,0,1
14819,0,0,0,0,1,1
14820,0,0,0,0,1,1
14821,1,0,0,0,0,1
14822,1,0,0,0,0,1
14823,0,0,0,0,1,1
14824,0,0,0,0,1,1
14825,0,1,0,0,0,1
14826,0,1,0,0,0,1
14827,0,0,0,0,1,1
14828,0,1,0,0,0,1
14829,0,1,0,0,0,1
14830,0,1,0,0,0,1
14831,0,1,0,0,0,1
14832,0,1,0,0,0,1
14833,0,0,0,0,1,1
14834,0,0,0,0,1,1
14835,1,0,0,0,0,1
14836,0,1,0,0,0,1
14837,0,0,0,0,1,1
14838,0,0,0,0,1,1
14839,0,1,0,0,0,1
14840,0,1,0,0,0,1
14841,1,0,0,0,0,1
14842,0,0,0,1,0,1
14843,0,1,0,0,0,1
14844,0,1,0,0,0,1
14845,0,0,0,1,0,1
14846,0,0,0,1,0,1
14847,0,1,0,0,0,1
14848,0,1,0,0,0,1
14849,0,1,0,0,0,1
14850,0,0,0,1,0,1
14851,0,1,0,0,0,1
14852,1,0,0,0,0,1
14853,0,1,0,0,0,1
14854,1,0,0,0,0,1
14855,1,0,0,0,0,1
14856,1,0,0,0,0,1
14857,0,0,0,1,0,1
14858,1,0,0,0,0,1
14859,0,0,1,0,0,1
14860,0,0,0,1,0,1
14861,1,0,0,0,0,1
14862,0,0,0,1,0,1
14863,0,0,1,0,0,1
14864,0,0,0,1,0,1
14865,0,0,1,0,0,1
14866,0,1,0,0,0,1
14867,0,0,0,0,1,1
14868,0,1,0,0,0,1
14869,0,1,0,0,0,1
14870,0,0,0,0,1,1
14871,0,0,0,0,1,1
14872,0,1,0,0,0,1
14873,0,0,0,0,1,1
14874,0,0,0,0,1,1
14875,0,0,0,0,1,1
14876,0,0,1,0,0,1
14877,0,0,0,0,1,1
14878,1,0,0,0,0,1
14879,0,0,0,0,1,1
14880,0,1,0,0,0,1
14881,1,0,0,0,0,1
14882,0,0,0,0,1,1
14883,1,0,0,0,0,1
14884,0,1,0,0,0,1
14885,1,0,0,0,0,1
14886,0,0,0,0,1,1
14887,0,0,0,0,1,1
14888,1,0,0,0,0,1
14889,0,0,0,0,1,1
14890,0,1,0,0,0,1
14891,0,1,0,0,0,1
14892,0,1,0,0,0,1
14893,0,1,0,0,0,1
14894,0,0,0,1,0,1
14895,0,0,0,0,1,1
14896,1,0,0,0,0,1
14897,1,0,0,0,0,1
14898,1,0,0,0,0,1
14899,1,0,0,0,0,1
14900,0,0,0,1,0,1
14901,0,0,0,1,0,1
14902,1,0,0,0,0,1
14903,0,1,0,0,0,1
14904,1,0,0,0,0,1
14905,1,0,0,0,0,1
14906,0,0,0,1,0,1
14907,0,0,0,1,0,1
14908,0,1,0,0,0,1
14909,0,0,1,0,0,1
14910,0,0,1,0,0,1
14911,0,1,0,0,0,1
14912,1,0,0,0,0,1
14913,0,1,0,0,0,1
14914,0,0,0,1,0,1
14915,1,0,0,0,0,1
14916,0,0,0,0,1,1
14917,0,1,0,0,0,1
14918,0,0,0,0,1,1
14919,0,1,0,0,0,1
14920,0,1,0,0,0,1
14921,0,1,0,0,0,1
14922,0,1,0,0,0,1
14923,0,1,0,0,0,1
14924,0,1,0,0,0,1
14925,0,1,0,0,0,1
14926,0,0,0,0,1,1
14927,0,0,1,0,0,1
14928,0,0,0,1,0,1
14929,0,1,0,0,0,1
14930,0,0,0,1,0,1
14931,0,1,0,0,0,1
14932,0,1,0,0,0,1
14933,0,1,0,0,0,1
14934,0,0,0,1,0,1
14935,0,0,0,1,0,1
14936,0,1,0,0,0,1
14937,1,0,0,0,0,1
14938,1,0,0,0,0,1
14939,1,0,0,0,0,1
14940,1,0,0,0,0,1
14941,1,0,0,0,0,1
14942,0,0,0,1,0,1
14943,1,0,0,0,0,1
14944,1,0,0,0,0,1
14945,0,1,0,0,0,1
14946,0,1,0,0,0,1
14947,1,0,0,0,0,1
14948,0,1,0,0,0,1
14949,0,0,0,0,1,1
14950,1,0,0,0,0,1
14951,1,0,0,0,0,1
14952,0,1,0,0,0,1
14953,0,1,0,0,0,1
14954,0,0,0,0,1,1
14955,0,0,0,0,1,1
14956,0,0,0,0,1,1
14957,0,0,0,0,1,1
14958,0,0,0,0,1,1
14959,0,0,0,0,1,1
14960,0,0,1,0,0,1
14961,0,0,0,0,1,1
14962,0,0,0,0,1,1
14963,0,0,0,0,1,1
14964,0,1,0,0,0,1
14965,0,1,0,0,0,1
14966,0,1,0,0,0,1
14967,0,0,0,0,1,1
14968,0,1,0,0,0,1
14969,0,0,0,0,1,1
14970,0,1,0,0,0,1
14971,0,0,0,1,0,1
14972,0,0,0,0,1,1
14973,1,0,0,0,0,1
14974,0,1,0,0,0,1
14975,0,0,0,1,0,1
14976,0,0,0,1,0,1
14977,0,1,0,0,0,1
14978,0,1,0,0,0,1
14979,1,0,0,0,0,1
14980,1,0,0,0,0,1
14981,0,1,0,0,0,1
14982,0,1,0,0,0,1
14983,1,0,0,0,0,1
14984,0,0,1,0,0,1
14985,0,0,0,1,0,1
14986,0,0,0,1,0,1
14987,0,0,0,1,0,1
14988,0,0,1,0,0,1
14989,0,0,1,0,0,1
14990,0,0,1,0,0,1
14991,0,0,1,0,0,1
14992,0,1,0,0,0,1
14993,1,0,0,0,0,1
14994,0,0,0,1,0,1
14995,0,1,0,0,0,1
14996,0,1,0,0,0,1
14997,0,1,0,0,0,1
14998,0,1,0,0,0,1
14999,0,1,0,0,0,1
15000,0,1,0,0,0,1
15001,0,0,0,0,1,1
15002,0,1,0,0,0,1
15003,0,0,0,0,1,1
15004,0,1,0,0,0,1
15005,0,1,0,0,0,1
15006,0,1,0,0,0,1
15007,0,0,1,0,0,1
15008,0,0,0,1,0,1
15009,0,0,0,1,0,1
15010,0,0,1,0,0,1
15011,0,0,0,1,0,1
15012,0,0,0,1,0,1
15013,0,0,0,0,1,1
15014,0,1,0,0,0,1
15015,1,0,0,0,0,1
15016,0,0,1,0,0,1
15017,0,0,0,1,0,1
15018,0,1,0,0,0,1
15019,1,0,0,0,0,1
15020,0,1,0,0,0,1
15021,1,0,0,0,0,1
15022,0,0,1,0,0,1
15023,0,1,0,0,0,1
15024,0,1,0,0,0,1
15025,0,1,0,0,0,1
15026,0,1,0,0,0,1
15027,0,1,0,0,0,1
15028,0,1,0,0,0,1
15029,0,0,0,1,0,1
15030,0,0,0,1,0,1
15031,0,0,0,0,1,1
15032,0,1,0,0,0,1
15033,1,0,0,0,0,1
15034,0,0,0,1,0,1
15035,0,1,0,0,0,1
15036,0,0,0,0,1,1
15037,0,0,0,0,1,1
15038,1,0,0,0,0,1
15039,0,0,0,0,1,1
15040,0,0,0,0,1,1
15041,0,1,0,0,0,1
15042,0,0,0,0,1,1
15043,0,0,1,0,0,1
15044,0,0,0,1,0,1
15045,0,0,0,1,0,1
15046,0,0,0,0,1,1
15047,0,0,0,0,1,1
15048,1,0,0,0,0,1
15049,0,1,0,0,0,1
15050,0,1,0,0,0,1
15051,1,0,0,0,0,1
15052,0,1,0,0,0,1
15053,1,0,0,0,0,1
15054,0,1,0,0,0,1
15055,0,0,0,1,0,1
15056,0,0,0,0,1,1
15057,0,0,0,0,1,1
15058,0,0,0,0,1,1
15059,0,1,0,0,0,1
15060,1,0,0,0,0,1
15061,0,0,0,0,1,1
15062,0,0,0,1,0,1
15063,0,0,0,0,1,1
15064,1,0,0,0,0,1
15065,0,0,0,1,0,1
15066,0,0,0,1,0,1
15067,0,0,0,1,0,1
15068,0,1,0,0,0,1
15069,0,1,0,0,0,1
15070,0,0,1,0,0,1
15071,0,0,0,0,1,1
15072,0,0,0,0,1,1
15073,1,0,0,0,0,1
15074,1,0,0,0,0,1
15075,0,0,0,0,1,1
15076,0,0,0,0,1,1
15077,0,0,0,0,1,1
15078,0,1,0,0,0,1
15079,0,1,0,0,0,1
15080,0,1,0,0,0,1
15081,0,0,0,0,1,1
15082,0,1,0,0,0,1
15083,0,0,0,0,1,1
15084,0,1,0,0,0,1
15085,0,0,0,0,1,1
15086,0,0,0,1,0,1
15087,0,0,0,0,1,1
15088,0,1,0,0,0,1
15089,0,0,0,1,0,1
15090,0,0,0,0,1,1
15091,0,0,0,0,1,1
15092,0,0,0,0,1,1
15093,0,0,0,0,1,1
15094,1,0,0,0,0,1
15095,0,1,0,0,0,1
15096,0,1,0,0,0,1
15097,0,0,0,1,0,1
15098,0,1,0,0,0,1
15099,0,1,0,0,0,1
15100,0,0,0,0,1,1
15101,0,0,0,0,1,1
15102,0,0,0,0,1,1
15103,0,0,0,0,1,1
15104,0,0,0,0,1,1
15105,0,0,0,0,1,1
15106,0,0,0,0,1,1
15107,0,0,0,0,1,1
15108,0,0,0,0,1,1
15109,0,0,0,0,1,1
15110,0,0,0,0,1,1
15111,0,0,0,0,1,1
15112,0,0,1,0,0,1
15113,0,0,0,0,1,1
15114,0,0,0,0,1,1
15115,0,0,0,0,1,1
15116,1,0,0,0,0,1
15117,0,1,0,0,0,1
15118,0,0,0,1,0,1
15119,1,0,0,0,0,1
15120,0,1,0,0,0,1
15121,0,0,0,1,0,1
15122,0,1,0,0,0,1
15123,1,0,0,0,0,1
15124,0,0,0,0,1,1
15125,0,0,0,0,1,1
15126,0,0,1,0,0,1
15127,1,0,0,0,0,1
15128,0,1,0,0,0,1
15129,0,1,0,0,0,1
15130,0,0,0,1,0,1
15131,0,1,0,0,0,1
15132,0,0,0,0,1,1
15133,0,0,0,0,1,1
15134,0,0,0,0,1,1
15135,1,0,0,0,0,1
15136,1,0,0,0,0,1
15137,1,0,0,0,0,1
15138,0,1,0,0,0,1
15139,0,0,0,0,1,1
15140,0,1,0,0,0,1
15141,0,0,0,0,1,1
15142,0,0,0,0,1,1
15143,0,0,0,0,1,1
15144,0,0,0,0,1,1
15145,0,0,0,0,1,1
15146,0,0,0,0,1,1
15147,0,1,0,0,0,1
15148,0,0,0,0,1,1
15149,1,0,0,0,0,1
15150,1,0,0,0,0,1
15151,0,0,0,0,1,1
15152,1,0,0,0,0,1
15153,1,0,0,0,0,1
15154,0,1,0,0,0,1
15155,0,1,0,0,0,1
15156,0,0,0,0,1,1
15157,0,0,0,0,1,1
15158,0,0,0,0,1,1
15159,0,0,0,0,1,1
15160,1,0,0,0,0,1
15161,1,0,0,0,0,1
15162,0,0,0,0,1,1
15163,0,0,0,0,1,1
15164,0,1,0,0,0,1
15165,0,1,0,0,0,1
15166,0,1,0,0,0,1
15167,0,0,0,0,1,1
15168,0,0,0,0,1,1
15169,1,0,0,0,0,1
15170,1,0,0,0,0,1
15171,1,0,0,0,0,1
15172,1,0,0,0,0,1
15173,1,0,0,0,0,1
15174,1,0,0,0,0,1
15175,0,1,0,0,0,1
15176,0,1,0,0,0,1
15177,0,1,0,0,0,1
15178,0,1,0,0,0,1
15179,0,1,0,0,0,1
15180,0,1,0,0,0,1
15181,0,1,0,0,0,1
15182,0,1,0,0,0,1
15183,0,1,0,0,0,1
15184,0,1,0,0,0,1
15185,0,0,0,0,1,1
15186,0,0,0,0,1,1
15187,0,1,0,0,0,1
15188,0,0,0,0,1,1
15189,0,1,0,0,0,1
15190,0,1,0,0,0,1
15191,0,0,0,0,1,1
15192,0,0,0,0,1,1
15193,0,0,0,0,1,1
15194,0,0,0,0,1,1
15195,0,1,0,0,0,1
15196,0,1,0,0,0,1
15197,0,0,0,0,1,1
15198,0,0,0,0,1,1
15199,0,1,0,0,0,1
15200,0,0,0,0,1,1
15201,0,0,0,0,1,1
15202,1,0,0,0,0,1
15203,1,0,0,0,0,1
15204,0,1,0,0,0,1
15205,1,0,0,0,0,1
15206,0,1,0,0,0,1
15207,1,0,0,0,0,1
15208,1,0,0,0,0,1
15209,1,0,0,0,0,1
15210,1,0,0,0,0,1
15211,1,0,0,0,0,1
15212,1,0,0,0,0,1
15213,0,0,0,0,1,1
15214,0,0,0,0,1,1
15215,0,0,0,0,1,1
15216,0,0,0,0,1,1
15217,1,0,0,0,0,1
15218,1,0,0,0,0,1
15219,1,0,0,0,0,1
15220,0,1,0,0,0,1
15221,0,0,0,0,1,1
15222,1,0,0,0,0,1
15223,0,0,0,0,1,1
15224,0,0,0,0,1,1
15225,1,0,0,0,0,1
15226,0,0,0,0,1,1
15227,0,0,0,0,1,1
15228,0,1,0,0,0,1
15229,0,1,0,0,0,1
15230,0,1,0,0,0,1
15231,0,0,0,0,1,1
15232,1,0,0,0,0,1
15233,0,1,0,0,0,1
15234,1,0,0,0,0,1
15235,0,1,0,0,0,1
15236,0,1,0,0,0,1
15237,1,0,0,0,0,1
15238,0,1,0,0,0,1
15239,0,1,0,0,0,1
15240,0,1,0,0,0,1
15241,0,1,0,0,0,1
15242,0,1,0,0,0,1
15243,0,1,0,0,0,1
15244,0,1,0,0,0,1
15245,0,1,0,0,0,1
15246,0,0,0,0,1,1
15247,0,0,0,0,1,1
15248,0,1,0,0,0,1
15249,0,1,0,0,0,1
15250,1,0,0,0,0,1
15251,1,0,0,0,0,1
15252,0,0,0,0,1,1
15253,1,0,0,0,0,1
15254,1,0,0,0,0,1
15255,0,1,0,0,0,1
15256,0,1,0,0,0,1
15257,0,1,0,0,0,1
15258,1,0,0,0,0,1
15259,0,1,0,0,0,1
15260,0,1,0,0,0,1
15261,1,0,0,0,0,1
15262,1,0,0,0,0,1
15263,0,1,0,0,0,1
15264,1,0,0,0,0,1
15265,1,0,0,0,0,1
15266,0,1,0,0,0,1
15267,1,0,0,0,0,1
15268,1,0,0,0,0,1
15269,1,0,0,0,0,1
15270,0,1,0,0,0,1
15271,1,0,0,0,0,1
15272,0,1,0,0,0,1
15273,0,1,0,0,0,1
15274,0,1,0,0,0,1
15275,0,1,0,0,0,1
15276,0,0,0,0,1,1
15277,0,1,0,0,0,1
15278,0,1,0,0,0,1
15279,0,1,0,0,0,1
15280,0,1,0,0,0,1
15281,0,1,0,0,0,1
15282,0,1,0,0,0,1
15283,0,1,0,0,0,1
15284,0,1,0,0,0,1
15285,0,1,0,0,0,1
15286,1,0,0,0,0,1
15287,0,1,0,0,0,1
15288,0,1,0,0,0,1
15289,0,0,0,0,1,1
15290,0,0,0,0,1,1
15291,0,1,0,0,0,1
15292,0,1,0,0,0,1
15293,0,1,0,0,0,1
15294,0,1,0,0,0,1
15295,1,0,0,0,0,1
15296,1,0,0,0,0,1
15297,0,0,0,0,1,1
15298,0,0,0,0,1,1
15299,0,0,0,0,1,1
15300,0,0,0,0,1,1
15301,0,0,0,0,1,1
15302,0,0,0,0,1,1
15303,0,0,0,0,1,1
15304,0,0,0,0,1,1
15305,0,0,0,0,1,1
15306,0,1,0,0,0,1
15307,0,0,0,1,0,1
15308,0,0,0,0,1,1
15309,0,0,0,1,0,1
15310,1,0,0,0,0,1
15311,0,0,0,1,0,1
15312,0,0,0,1,0,1
15313,0,1,0,0,0,1
15314,1,0,0,0,0,1
15315,1,0,0,0,0,1
15316,0,1,0,0,0,1
15317,0,0,0,0,1,1
15318,0,1,0,0,0,1
15319,0,0,0,0,1,1
15320,1,0,0,0,0,1
15321,1,0,0,0,0,1
15322,1,0,0,0,0,1
15323,0,0,0,0,1,1
15324,0,0,0,0,1,1
15325,0,0,0,0,1,1
15326,1,0,0,0,0,1
15327,1,0,0,0,0,1
15328,1,0,0,0,0,1
15329,0,1,0,0,0,1
15330,0,0,0,0,1,1
15331,0,0,0,1,0,1
15332,0,0,0,1,0,1
15333,0,0,0,1,0,1
15334,0,1,0,0,0,1
15335,0,0,0,0,1,1
15336,0,1,0,0,0,1
15337,0,1,0,0,0,1
15338,0,1,0,0,0,1
15339,0,1,0,0,0,1
15340,0,1,0,0,0,1
15341,0,0,0,1,0,1
15342,0,0,0,1,0,1
15343,0,1,0,0,0,1
15344,1,0,0,0,0,1
15345,0,1,0,0,0,1
15346,0,1,0,0,0,1
15347,1,0,0,0,0,1
15348,0,1,0,0,0,1
15349,0,0,0,0,1,1
15350,0,0,0,0,1,1
15351,0,1,0,0,0,1
15352,1,0,0,0,0,1
15353,1,0,0,0,0,1
15354,1,0,0,0,0,1
15355,1,0,0,0,0,1
15356,0,0,0,0,1,1
15357,1,0,0,0,0,1
15358,1,0,0,0,0,1
15359,1,0,0,0,0,1
15360,0,1,0,0,0,1
15361,0,0,0,0,1,1
15362,0,0,0,0,1,1
15363,0,0,0,0,1,1
15364,0,1,0,0,0,1
15365,0,0,0,0,1,1
15366,0,0,0,0,1,1
"TOTAL",11892,14859,11853,8488,10612,57704
